Version: 2
DEFAULT
7.0,1.0
Point14:33.0,13.0;Point13:44.0,12.0;Point12:44.0,16.0;Point11:41.0,16.0;Point1:3.0,16.0;Point0:17.0,14.0;Point3:40.0,2.0;Point2:41.0,1.0;Point5:38.0,4.0;Point4:43.0,3.0;Point7:18.0,1.0;Point6:18.0,17.0;Point9:36.0,14.0;Point10:39.0,14.0;Point8:46.0,14.0
BookshelfLarge:4.0,5.0
WWWWWWWWWWWWWWWWWWWWWWWWWWWWWWWWWWWWWWWWWWWWWWWW
WFFFFFFFFWFFFFFWHFFWFFFWFWFFFFFWFFFFFPPFFFPPFFFW
WFFFFFFFFWFFFFFWFFHWFFFWFWFFFFFWFFFFFPPFFFPPFFFW
WFFFFFFFFWFFFFFWFFFWFFFWFWFFFFFWFFFFFPPFFFPPFFFW
WFFFFFFFFWFFFFFWFFFWFFFWEWFFFFFWFFFFFPPFFFPPFFFW
WFFFFFFFFWFFFFFWFFFWFFFFFFFFFFFWFFFFFPPFFFPPFFFW
WWWWWDWWWWFFFFFWWPWWFFFFFFFFFFFWFFFFFPPFFFPPFFFW
WFFFFFFFFFFFFFFFFFFFFFFFFFFFFFFWWDWWWWWWWPPPFFFW
WFFFFFFFFFFFFFFFFFFFFFFFFFFFFFFFFFFFFFFFWWWWWWWW
WFFFFFFFFFFFFFFFFFFFFFFFFFFFFFFFFFFFFFFFFFFFFFFW
WFFFFFFFFFFFFFFFFFFFFFFFFFFFFFFFFFFFFFFFFFFFFFFW
WFFFFFFFFFWWWWWWWWWWWWWWWWWWWFFFFFFFFFFFFFFFFFFW
WFFFFFFFFFWFFFFFFFFFFFFFFFFFWFFFFFFWWWWWDWWWWWWW
WFFFFFFFFFWFFFFFFFFFFFFFFFFFWFFFFFFWFFFFFFFFFFFW
WFFFFFFFFFWFFFFFFFFFFFFFFFFFWFFFFFFWFFFFFFFFFFFW
WFFFFFFFFFWFFFFFFFFFFFFFFFFFWFFFFFFWFFFFFFFFFFFW
WFFFFFFFFFWFFFFFFFFFFFFFFFFFDFFFFFFWFFFFFFFFFFFW
WFFFFFFFFFWFFFFFFFFFFFFFFFFFWFFFFFFWFFFFFFFFFFFW
WWWWWWWWWWWWWWWWWWWWWWWWWWWWWWWWWWWWWWWWWWWWWWWW