DEFAULT
1,1
7,3;7,7;8,2;11,2;10,9;13,9;
WWWWWWWWWWWWWWWWWWWWWWWWWWWWWWWWWSSS
WFFFFFFFFPPFFFFFFFFFFFFFFFFWFFFFWSSS
WFFFFFFFFPPFFFFFFFFFFFFFFFFDFFFFWSSS
WFFFFFFFFPPFFFFFFFFFFFFFFFFWFFFFWSSS
WFFFPPPPPPPPPPPPPPPPPPPPPPPWFPWWWSSS
WFFFSPPPPPPPPPPPPPPPPPPPPPPWFFFEWSSS
WFFFPPFFFFFPPFFFFFFFFFFFFFFWFPWWWSSS
WFFFPPFFFFFPPFFFFFFFFFFFFFFWFFFFWSSS
WFFFPPFFFFFPPFFFFFFFFFFFFFFDFFFWWSSS
WFFFPPFFFFFSPFFFFFFFFFFFFFFWWWWWPSSS
WFFFPPFFFFFSPFFFFFFFFFFFFFFWPPPPPSSS
WWWWWWWWWWWWWWWWWWWWWWWWWWWWPPPPPSSS

