DEFAULT
1,1
7,3;7,7;8,2;11,2;10,9;13,9;;20,8;20,1;17,6;17,2;31,3;31,7;
WWWWWWWWWWWWWWWWWWWWWWWWWWWWWWWWW
WFFFFFFFFPPFFFFFFFFFFFFFFFFWFFFFW
WFFFFFFFFPPFFFFFFFFFFFFFFFFDFFFFW
WFFFFFFFFPPFFFFFFFFFFFFFFFFWFFFFW
WFFFPPPPPPPPPPPPPPPPPPPPPPPWFPWWW
WFFFPPPPPPPPPPPPPPPPPPPPPPPWFFFEW
WFFFPPFFFFFPPFFFFFFFFFFFFFFWFPWWW
WFFFPPFFFFFPPFFFFFFFFFFFFFFWFFFFW
WFFFPPFFFFFPPFFFFFFFFFFFFFFDFFFWW
WFFFPPFFFFFPPFFFFFFFFFFFFFFWWWWWP
WFFFPPFFFFFPPFFFFFFFFFFFFFFWPPPPP
WWWWWWWWWWWWWWWWWWWWWWWWWWWWPPPPP



