DEFAULT
7,1
17,14;3,16;41,1;40,2;43,3;38,4;18,17;18,1;46,14;36,14;39,14;41,16;44,16;44,12;;33,13;
WWWWWWWWWWWWWWWWWWWWWWWWWWWWWWWWWWWWWWWWWWWWWWWW
WFFFFFFFFFWFFFFFFFFFFFFFFFFFWFFFFFFWFFFFFFFFFFFW
WFFFFFFFFFWFFFFFFFFFFFFFFFFFDFFFFFFWFFFFFFFFFFFW
WFFFFFFFFFWFFFFFFFFFFFFFFFFFWFFFFFFWFFFFFFFFFFFW
WFFFFFFFFFWFFFFFFFFFFFFFFFFFWFFFFFFWFFFFFFFFFFFW
WFFFFFFFFFWFFFFFFFFFFFFFFFFFWFFFFFFWFFFFFFFFFFFW
WFFFFFFFFFWFFFFFFFFFFFFFFFFFWFFFFFFWWWWWDWWWWWWW
WFFFFFFFFFWWWWWWWWWWWWWWWWWWWFFFFFFFFFFFFFFFFFFW
WFFFFFFFFFFFFFFFFFFFFFFFFFFFFFFFFFFFFFFFFFFFFFFW
WFFFFFFFFFFFFFFFFFFFFFFFFFFFFFFFFFFFFFFFFFFFFFFW
WFFFFFFFFFFFFFFFFFFFFFFFFFFFFFFFFFFFFFFFWWWWWWWW
WFFFFFFFFFFFFFFFFFFFFFFFFFFFFFFWWDWWWWWWWPPPFFFW
WWWWWDWWWWFFFFFWWPWWFFFFFFFFFFFWFFFFFPPFFFPPFFFW
WFFFFFFFFWFFFFFWFFFWFFFFFFFFFFFWFFFFFPPFFFPPFFFW
WFFFFFFFFWFFFFFWFFFWFFFWEWFFFFFWFFFFFPPFFFPPFFFW
WFFFFFFFFWFFFFFWFFFWFFFWFWFFFFFWFFFFFPPFFFPPFFFW
WFFFFFFFFWFFFFFWFFHWFFFWFWFFFFFWFFFFFPPFFFPPFFFW
WFFFFFFFFWFFFFFWHFFWFFFWFWFFFFFWFFFFFPPFFFPPFFFW
WWWWWWWWWWWWWWWWWWWWWWWWWWWWWWWWWWWWWWWWWWWWWWWW
