DEFAULT
3.5920148,1.5344938
3,3;9,8;4,13;8,13;
WWWWWWWWWWWWW
WFFFFFFFFFFFW
WFFFFFFFFFFFW
WFFFFFFFFFFFW
WFFFFFFFFFFFW
WWWWWWDWWWWWW
WFFFFFFFFFFFW
WFFFFFFFFFFFW
WFFFFFFFFFFFW
WFFFFFFFFFFFW
WFFFFFFFFFFFW
WFFFFFFFFFFFW
WFFFFFFFFFFFW
WFFFFWEWFFFFW
WWWWWWWWWWWWW

