DEFAULT
7,1
17,14;3,16;38,1;40,2;43,3;38,4;18,17;18,1;
WWWWWWWWWWWWWWWWWWWWWWWWWWWWWWWWWWWWWWWWWWWWWWWW
WFFFFFFFFFWFFFFFFFFFFFFFFFFFWFFFFFFWFFFFFFFFFFFW
WFFFFFFFFFWFFFFFFFFFFFFFFFFFDFFFFFFWFFFFFFFFFFFW
WFFFFFFFFFWFFFFFFFFFFFFFFFFFWFFFFFFWFFFFFFFFFFFW
WFFFFFFFFFWFFFFFFFFFFFFFFFFFWFFFFFFWFFFFFFFFFFFW
WFFFFFFFFFWFFFFFFFFFFFFFFFFFWFFFFFFWFFFFFFFFFFFW
WFFFFFFFFFWFFFFFFFFFFFFFFFFFWFFFFFFWWWWWDWWWWWWW
WFFFFFFFFFWWWWWWWWWWWWWWWWWWWFFFFFFFFFFFFFFFFFFW
WFFFFFFFFFFFFFFFFFFFFFFFFFFFFFFFFFFFFFFFFFFFFFFW
WFFFFFFFFFFFFFFFFFFFFFFFFFFFFFFFFFFFFFFFFFFFFFFW
WFFFFFFFFFFFFFFFFFFFFFFFFFFFFFFFFFFFFFFFWWWWWWWW
WFFFFFFFFFFFFFFFFFFFFFFFFFFFFFFWWDWWWWWWWFFFFFFW
WWWWWDWWWWFFFFFWWPWWFFFFFFFFFFFWFFFFFFFFFFFFFFFW
WFFFFFFFFWFFFFFWFFFWFFFFFFFFFFFWFFFFFFFFFFFFFFFW
WFFFFFFFFWFFFFFWFFFWFFFWEWFFFFFWFFFFFFFFFFFFFFFW
WFFFFFFFFWFFFFFWFFFWFFFWFWFFFFFWFFFFFFFFFFFFFFFW
WFFFFFFFFWFFFFFWFFHWFFFWFWFFFFFWFFFFFFFFFFFFFFFW
WFFFFFFFFWFFFFFWHFFWFFFWFWFFFFFWFFFFFFFFFFFFFFFW
WWWWWWWWWWWWWWWWWWWWWWWWWWWWWWWWWWWWWWWWWWWWWWWW
