DEFAULT
2,23

WWWWWWWWWWWWWWWWWWWWWWWWWWWWWWWWWWWWWWWWWWWWW
WWWFFFFWWFWFFFWFFFFFFFFFFFWFFFFFFFFWFFFFFFFWW
WWWFWWFWWFWFWFWFWWWWWWFWWFWFWWFWWWWWWWWWFWFWW
WWWFWWFFFFWFWFWFWFFFFWFWWFWFWWFWFFFFFFFFFWFWW
WWWFWWFWWWWFWFFFFWWWFWFFWFWFFFFWWWWWWWWWFWFWW
WWWFWWFWWWWFWFWWFWWWFWFWWFWWWWFWFFFFFFFWFWFWW
WWFFFFFFFFFFWFWFFFFFFWFFWFFFFFFWFWWWWWFWFWFWW
WWFWWWWWWWWWWFWWWWFWWWWFWWWWFWFWFWFFFFFWFWFWW
WWFWWFFFFFFFFFFWFFFFFFWFFFFWFWFWFWFWWWWWFWFWW
WWFWWFWFWWWWWWFWFWWFWWWWWWFFFWFFFWFWFFFWFFFWW
WWFWWFWFWFFFFWFWFWWFWFWWFFFWFWFWWWFWFWFWFWWWW
WWFFFFWFWFWWFWFWFWEFWFWWFWWWFWFFFFFWFWFFFWWWW
WWWFWFWFWFWFFWFWFWWWWFWWFWFFFWFWWWWWFWWWWWFWW
WWWFWFWFWFWWWWFWFFFFFFFFFWFWWWWWFFFFFFFFFWFWW
WWWFWFWFWFFFFFFWFWWWWWFWFWWWFWFWWWWFWWWWFWFWW
WWWFWFWFWWWWWWWWFFFFFFFWFWFWFWFWFFFFFFFWFWFWW
WWWFWFWFWFFFFFFFFWWFWWWWFWFWFWFWFWWWWWFWFFFWW
WWWFWFWFWFWWWWWWWWWFFFFWWWFWFWFWFWFFFWFWWWWWW
WWWWWFWFWFFFFFWWWWWWWWFFFFFFFWFWFWFWFWFFFFFWW
WWFFWFWFWWWFWFWFFFFFFWFWFWWWWWFWFWFWFWFWWWFWW
WWFWWFWFFFWFWFWFWWWWWWFWFFFFFFFWFWWWFWFWFWFWW
WWFFFFWFWFWFWFWFFFFFFFFWFWWWWWWWFFFFFWFWFWFWW
WWWWWWWFWFWFWFWWWWWWWWFWFFFFFFFWWWWWFWFWFWFWW
WWFFFFFFWFFFWFFFFFFFFFFWWWWWWWFFFFFFFWFWFFFWW
WWWWWWWWWWWWWWWWWWWWWWWWWWWWWWWWWWWWWWWWWWWWW
