DEFAULT
2,23

WWWWWWWWWWWWWWWWWWWWWWWWWWWWWWWWWWWWWWWWWWWWW
WWFWFFFFFWFFFWFFFWFFFWFFFWFFFWFFFWFFFWWWWWEWW
WWFWFWFWFWFWFWFWFWFWFWFWFWFWFWFWFWFWWWFFFFFWW
WWFWFWFWFWFWFWFWFWFWFWFWFWFWFWFWFWFFFWFWWWWWW
WWFWFWFWFFFWFFFWFFFWFFFWFFFWFFFWFFFFWWFWFFFWW
WWFFFWFWWWWWWWWWWWWWWWWWWWWWWWWWWWWFWFFWFWFWW
WWFWFWFFFFFFWFFFFFFFFFFFFWWWFFFFFFFFWFWWFWFWW
WWFWFWFWWWWWWWWWWWWWWWFWFFFFFWWWWWWWWFWWFWFWW
WWFWFWFFFFFFFFWWFFFFFFFWFWWWWFFFFFFFFFFFFWFWW
WWFWFWWWWWWWWFFWWWWWWWFWFWFFFFWFWWWWWWWWFWFWW
WWFWFFFFFFFFWWFFWWFFFWFWFWWFWWWFWWWFFFWWWWFWW
WWFWWWFWWWWFWWWFFWFWFWFWFFWFWFFFFFFFWFFFFFFWW
WWWWWWFWFFFFFFWWWWFWFWFWFWFFWFWWWWWFWWWWWWFWW
WWFFFFFWWWWWWFFWWFFWFFFFFWFWWFWFFFFFWFFFFFFWW
WWFWWWFWFFWWWWFFFFWWWWWFWWWWWFWWWWWFWWWWWWWWW
WWFWFFFFFWWFFWWWWWWFFFFFFFFFWFFFFFFFFFFFFFFWW
WWFWWWWWFWFFWWFFFFFFWWWFWWWFWWWWWFWWWWWWWWFWW
WWFFFFFWFWFWWFFWWWWWWFWFWFFFFFFFWFWFFFFFFWFWW
WWFWWWFWFWFWFFWWFFFFFFWFWFWWWWWFWFWFWWWWWWFWW
WWFFFWFWWWFWFWWFFWWWWFWFWFWFFFFFWFWFFFFFFFFWW
WWFWFWFWFFFWFWFFWWFWWFWFWFWWWWWWWFWWWWWWWWWWW
WWFWFWFFFWWWFWFWWFFFFFWFWFFFFFFFFFFFFFFFFFFWW
WWFWFWWWWWFFFWFWWWWWWWWFWWWWWWWWWWWWWWWWWWFWW
WWFWFFFFFFFWWWFFFFFFFFFFFFFFFFFFFFFFFFFFFFFWW
WWWWWWWWWWWWWWWWWWWWWWWWWWWWWWWWWWWWWWWWWWWWW

