FOREST
10,54

WWWWWWWWWWWWWWWWWWWWWWWWWWWWWWWWWWWWWWWWWWWWWWWWWWWWWWWWWWWWWWWW
WFFFFFFFFFFFFFFFFFFFFFFFFFFFFFFFFFFFFFFFFFFFFFFFFFFFFFFFFFFFFFFW
WFFFFFFFFFFFFFFFFFFFFFFFFFFFFFFFFFFFFFFFFFFFFFFFFFFFFFFFFFFFFFFW
WFFFFFFFFFFFFFFFFFFFFFFFFFFFFFFFFFFFFFFFFFFFFFFFFFFFFFFFFFFFFFFW
WFFFFFFFFFFFFFFFFFFFFFFFFFFFFFFFFFFFFFFFFFFFFFFFFFFFFFFFFFFFFFFW
WFFFFFFFFFFFFFFFFFFFFFFFFFFFFFFFFFFFFFFFFFFFFFFFFFFFFFFFFFFFFFFW
WFFFFFFFFFFFFFFFFFFFFFFFFFFFFFFFFFFFFFFFFFFFFFFFFFFFFFFFFFFFFFFW
WFFFFFFFFFFFFFFFFFFFFFFFFFFFFFFFFFFFFFFFFFFFFFFFFFFFFFFFFFFFFFFW
WFFFFFFFFFFFFFFFFFFFFFFFFFFFFFFFFFFFFFFFFFFFFFFFFFFFFFFFFFFFFFFW
WFFFFFFFFFFFFFFFFFFFFFFFFFFFFFFFFFFFFFFFFFFFFFFFFFFFFFFFFFFFFFFW
WFFFFFFFFFFFFFFFFFFFFFFFFFFFFFFFFFFFFFFFFFFFFFFFFFFFFFFFFFFFFFFW
WFFFFFFFFFFFFFFFFFFFFFWWWWWWWWWWWWWWWWFFFFFFFFFFFFFFFFFFFFFFFFFW
WFFFFFFFFFFFFFFFFFFFFFWFFFFFFFFFFFWWWWFFFFFFFFFFFFFFFFFFFFFFFFFW
WFFFFFFFFFFFFFFFFFFFFFWFFFFFFFFFFWWWWWFFFFFFFFFFFFFFFFFFFFFFFFFW
WFFFFFFFFFFFFFFFFFFFFFWFFFFFFFFFFFDFEWFFFFFFFFFFFFFFFFFFFFFFFFFW
WFFFFFFFFFFFFFFFFFFFFFWFFFWWWWWWWWWWWWFFFFFFFFFFFFFFFFFFFFFFFFFW
WFFFFFFFFFFFFFFFFFFFFFWFFFWWWWWWWFWWWWFFFFFFFFFFFFFFFFFFFFFFFFFW
WFFFFFFFFFFFFFFFFFFFFFWFFFWWWWWWWWWWWWFFFFFFFFFFFFFFFFFFFFFFFFFW
WFFFFFFFFFFFFFFFFFFFFFWFFFWFFFFFFFFFFFFFFFFFFFFFFFFFFFFFFFFFFFFW
WFFFFFFFFFFFFFFFFFFFFFWFFFWFFFFFFFFFFFFFFFFFFFFFFFFFFFFFFFFFFFFW
WFFFFFFFFFFFFFFFFFFFFFWFFFWFFFFFFFFFFFFFFFFFFFFFFFFFFFFFFFFFFFFW
WFFFFFFFFFFFFFFFFFFFFFWFFFWFFFFFFFFFFFFFFFFFFFFFFFFFFFFFFFFFFFFW
WFFFFFFFFFFFFFFFFFFFFFWFFFFFFFFFFFFFFFFFFFFFFFFFFFFFFFFFFFFFFFFW
WFFFFFFFFFFFFFFFFFFFFFWFFFFFFFFFFFFFFFFFFFFFFFFFFFFFFFFFFFFFFFFW
WFFFFFFFFFFFFFFFFFFFFFFFFFFFFFFFFFFFFFFFFFFFFFFFFFFFFFFFFFFFFFFW
WFFFFFFFFFFFFFFFFFFFFFFFFFFFFFFFWFFFFFFFFFFFFFFFFFFFFFFFFFFFFFFW
WPFFFFFFFFFFFFFFFFFFFFFFFFFFFFFFWFFFFFFFFFFFFFFFFFFFFFFFFFFFFFFW
WPPFFFFFFFFFFFFFFFFFFFFFFFFFFFFFWFFFFFFFFFFFFFFFFFFFFFFFFFFFFFFW
PPPFFFFFFFFFFFFFFFFFFFFFFFFFFFFFWFFFFFFFFFFFFFFFFFFFFFFFFFFFFFFW
PPPPFFFFFFFFFFFFFFFFFFFFFFFFFFFFWFFFFFFFFFFFFFFFFFFFFFFFFFFFFFFW
PPPPPPPPPPPPPPPPPPPPPPFFFFFFFFFFWFFFFFFFFFFFFFFFFFFFFFFFFFFFFFFW
PPPPPPPPPWWWWWWWWWWWPPFFFFFFFFFFWFFFFFFFFFFFFFFFFFFFFFFFFFFFFFFW
PPPPPPPPWWFFFFFFFFFWWPFFFFFFFFFFWFFFFFFFFFFFFFFFFFFFFFFFFFFFFFFW
PPPPPPPWWFFFFFFFFFFFWPPFFFFFFFFFWFFFFFFFFFFFFFFFFFFFFFFFFFFFFFFW
PPPPPPPWFFFFFFFFFFFFWWPFFFFFFFFFWFFFFFFFFFFFFFFFFFFFFFFFFFFFFFFW
PPPPPPPWFFFFFFFFFWFFFWPFFFFFFFFFWFFFFFFFFFFFFFFFFFFFFFFFFFFFFFFW
PPPPPPPWFFFFWFFFFFFFFWPFFFFFFFFFWFFFFFFFFFFFFFFFFFFFFFFFFFFFFFFW
PPPPPPPWFFFFFFFFFFFFFWPFFFFFFFFFWFFFFFFFFFFFFFFFFFFFFFFFFFFFFFFW
PPPPPPPWFFFFFFFFFFFFFWPPFFFFFFFFWFFFFFFFFFFFFFFFFFFFFFFFFFFFFFFW
PPPPPPPWFFFFFFFFFFFFFWWPPFFFFFFFWFFFFFFFFFFFFFFFFFFFFFFFFFFFFFFW
PPPPPPPWFFFFWFFFFFWFFFWPPFFFFFFFWFFFFFFFFFFFFFFFFFFFFFFFFFFFFFFW
PPPPPPPWWFFFFFFFFFFFFFWPPPFFFFFFWFFFFFFFFFFFFFFFFFFFFFFFFFFFFFFW
PPPPPPPPWFFFFFFWFFFFFFWPPPFFFFFFWFFFFFFFFFFFFFFFFFFFFFFFFFFFFFFW
PPPPPPPPWWFFFFFFFFFFFFWPPPFFFFFFWFFFFFFFFFFFFFFFFFFFFFFFFFFFFFFW
PPPPPPPPPWWFFFFFFFFFFFWPPPFFFFFFWFFFFFFFFFFFFFFFFFFFFFFFFFFFFFFW
PPPPPPPPPPWWFFFFFFFFFFWPPPFFFFFFWFFFFFFFFFFFFFFFFFFFFFFFFFFFFFFW
PPPPPPPPPPPWWFFFFFFFFFWPPPFFFFFFWFFFFFFFFFFFFFFFFFFFFFFFFFFFFFFW
PPPPPPPPPPPPWWFFFFFFFFWPPPFFFFFFWFFFFFFFFFFFFFFFFFFFFFFFFFFFFFFW
PPPPPPPPPPPPPWFFFFFFFFWPPPFFFFFFWFFFFFFFFFFFFFFFFFFFFFFFFFFFFFFW
SSSSSSSSSSSSSWFFFFFFFFWPPPPFFFFFWFFFFFFFFFFFFFFFFFFFFFFFFFFFFFFW
WWWWWWWWWWWWWWFFFFFFFFWPPPPPPFFWWFFFFFFFFFFFFFFFFFFFFFFFFFFFFFFW
WFFFFFFFFFFFFFFFFFFFFFWWPPPPPFWWFFFFFFFFFFFFFFFFFFFFFFFFFFFFWWWW
WFFFFFFFFFFFFFFFFFFFFFFWWWPPPFWFFFFFFFFFFFFFFFFFFFFFFFFFFFWWWPPP
WFFFFFFFFFFFFFFFFFFFFFFFFWWWWWWFFFFFFFFFFFFFFFFFFFFFFFFFFWWPPPPP
WFFFFFFFFFFFFFFFFFFFFFFFFFFFFFFFFFFFFFFFFFFFFFFFFFFFEFFWWWPPPPPP
WFFFFFFFFFFFFFFFFFFFFFFFFFFFFFFFFFFFFFWWWWWWWWWWWWWWWWWWPPPPPPPP
WFFFFFFFFFFFFFFFFFFFFFFFFFFFFFFFFFFFFWWPPPPPPPPPPPPPPPPPPPPPPPPP
WWWWWWWWWWWWWWFFFFFFFFFFFFFFFFFFFFFWWWPPPPPPPPPPPPPPPPPPPPPPPPPP
SSSSSSSSSSSSSWFFFFFFFFFFFFFFFFFFWWWWPPPPPPPPPPPPPPPPPPPPPPPPPPPP
SSSSSSSSSSSSSWFFFFFFFFFFFFFFFFFWWPPPPPPPPPPPPPPPPPPPPPPPPPPPPPPP
SSSSSSSSSSSSSWFFFFFFFFFFFFFFFFWWPPPPPPPPPPPPPPPPPPPPPPPPPPPPPPPP
SSSSSSSSSSSSSWWWWWWWWWWWWWWWWWWPPPPPPPPPPPPPPPPPPPPPPPPPPPPPPPPP
