FOREST
4.3501186,3.9003453

WWWWWWWWWWWWWWWWPPPPPPPPPPPPPPP
WFWFFFWWWFFWFFFWWWWPPPPPPPPPPPP
WFFFFFFFWFFWWFFFFFWWWWPPPPPPPPP
WWWFFFWFFFFFFFFFFFDFEWPPPPPPPPP
WEWFFFWWWFFFFFWWWWWWWWPPPPPPPPP
WFFFFFFWWWFFFWWPPPPPPPPPPPPPPPP
WWWWWWWWWWWWWWPPPPPPPPPPPPPPPPP
