DEFAULT
1,13

WWWWWWWWWWWWWWW
WFFFFFWFFWWWFFW
WWWFWWWWFFFWWFW
WWFFFFFWFWFFWFW
WWFWFWWWFWWFFFW
WWFWFWFWWFFFWFW
WFFWWFFWFFWWWFW
WFWWFFWWWFWFFFW
WFFFFWWFFFWFWWW
WFWWWWWFWWWWWFW
WFFFFFFFWFFFFFW
WWWWFWWWWEWFWWW
WWWWFFFFWWWFFFW
WFFFFWWFFFFFWWW
WWWWWWWWWWWWWWW
