ICE
4,3

WWWWWWWWW
WFWFFFWFW
WFWWFWWFW
WFFFFFFFW
WFWWFWWFW
WEWFFFWFW
WWWWWWWWW
