FOREST
7,1

WWWWWWWWW
WFWFWFFFW
WFFFWWWFW
WWWFFFFFW
WEWFWWWFW
WFFFWFFFW
WWWWWWWWW
