DEFAULT
1,15
10,13;5,5;8,13;15,17;4,3;5,1;8,1;12,3;19,3;
SSSWWWWWWWWWWWSSWWEWW
SSSWFFFFFFFFFWSSWFFFW
SSSWFFFFFFFFFWWWWFFFW
SSSWFFFFFFFFFWFFFFFFW
SSSWWWWWWFFFFFFFFFFFW
SSSWFFFFDFFFFFFWWFFFW
SSSWFFFFWFFFFFFWWWWWW
SSSWFFFFWFFFFWWWWSSSS
SSSWWWWWWWFWWDSSSSSSS
SSSSWWWWWWDWWWSSSSSSS
SSSSWFFFFFFFFWSSSSSSS
SSSSWFWWWWWWFWSSSSSSS
SSSSWFWWFWWWDWSSSSSSS
SSSSWFWWFFFFFWSSSSSSS
WWWWWFWWFWWWWWSSSSSSS
WFFFFFFDFWSSSWWWWSSSS
WWWWWWWWFWWWWWFFWSSSS
SSSSSSSWFFFFDFFFWSSSS
SSSSSSSWWWWWWFFFWSSSS
SSSSSSSSSSSSWWWWWSSSS

