DEFAULT
4.0,10.0
24,20;29,18;33,18;58,11;12,17;26,20;34,14;
SSSSSSSSSSSSSSSSSSSSSSSSSSSSSSSSSSSWWWWWWWSSSSSSSSSSSSSSSSSSSSSSSSSSSS
SSSSSSSSSSSSSSSSSSSSSSSSSSSSSSSSSSSWHFFFHWSSSSSSSSSSSSSSSSSSSSSSSSSSSS
SSSSSSSSSSSSSSSSSSSSSSSSSSSSSSSSSSSWFFEFFWSSSSSSSSSSSSSSSSSSSSSSSSSSSS
SSSSSSSSSSSSSSSSSSSSSSSSSSSSSSSSSSSWFFFFFWSSSSSSSSSSSSSSSSSSSSSSSSSSSS
SSSSSSSSSSSSSSSSSSSSSSSSSSSSSSSSSSSWFFFFFWSSSSSSSSSSSSSSSSSSSSSSSSSSSS
SSSSSSSSSSSSSSSSSSSSSSSSSSSSSSSSSSSWWFFFWWSSSSSSSSSSSSSSSSSSSSSSSSSSSS
SSSSSSSSSSSSSSSSSSSSSSSSSSSSSSSSSSSSWFFFWSSSSSSSSSSSSSSSSSSSSSSSSSSSSS
SSSSSSSSSSSSSSSSSSSSSSSSSSSSSSSSSSSSWFFFWSSSSSSSSSSSSSSSSSSSSSSSSSSSSS
SSSSSSSSSSSSSSSSSSSSSSSSSSSSSSWWWWWWWFFFWWWWWWWWWWWWWWWWWWWWWSSSSSSSSS
SSSWWWWWWWWSSSSSSSSSSSSSSSSSSSWPPPPPPPFPPPPPPPPPPPPPPPPPPHHHWSSSSSSSSS
SSSWFFFFFFWSSSSSSSSSSSSSSSSSSSWPPPPPPPFPPPPPPPPPPPPPPPPPPFFFWSSSSSSSSS
SSSWFFFFFFWSSSSSSSSSSSSSSSSSSSWPPPFFFFFPPPPPPPPPPPPPFFFFFFFFWSSSSSSSSS
SSSWFFFFFFWSSSSSSSSSSSSSSSSSSSWPPPFPPPPPPPPPPPPPPPPPPPPPPFFFWSSSSSSSSS
SSSWFFFFFFWSSSSSSSSSSSSSSSSSSSWPPPFPPPPPPPPPPPPPPPPPPPPPPHHHWSSSSSSSSS
SSSWHFFFFFWSWWWWWWWWWWWWWWWWWWWWWWDWWWWWWWWWWWWWWWWWWWWWWWWWWSSSSSSSSS
SSSWWWWWWFWSWFFFFFFFFFFHHHWFFFFFFFFFFFWSSSSSSSSSSSSSSSSSSSSSSSSSSSSSSS
SSSSSSSSWFWWWFFFFFFFFFFFHHWFFFFFFFFFFFWSSSSSSSSSSSSSSSSSSSSSSSSSSSSSSS
SSSSSSSSWFFFDFFFFFFFFFFFFFWFFFFFFFFFFHWSSSSSSSSSSSSSSSSSSSSSSSSSSSSSSS
SSSSSSSSWWWWWFFFFFFFFFFFFFWFFFFFFFFFHHWSSSSSSSSSSSSSSSSSSSSSSSSSSSSSSS
SSSSSSSSSSSSWFFFFFFFFFFFFFWFFFFFFFFHHHWSSSSSSSSSSSSSSSSSSSSSSSSSSSSSSS
SSSSSSSSSSSSWHFFFFFFFFFFFFDFFFFFFFHHHHWSSSSSSSSSSSSSSSSSSSSSSSSSSSSSSS
SSSSSSSSSSSSWHHHFFFFFFFFFFWFFFFFFHHHHHWSSSSSSSSSSSSSSSSSSSSSSSSSSSSSSS
SSSSSSSSSSSSWWWWWWWWWWWWWWWWWWWWWWWWWWWSSSSSSSSSSSSSSSSSSSSSSSSSSSSSSS