DEFAULT
4.0,10.0
SSSSSSSSSSSSSSSSSSSSSSSSSSSSSSSSSSSWWWWWWWSSSSSSSSSSSSSSSSSSSSSSSSSSSS
SSSSSSSSSSSSSSSSSSSSSSSSSSSSSSSSSSSWHFFFHWSSSSSSSSSSSSSSSSSSSSSSSSSSSS
SSSSSSSSSSSSSSSSSSSSSSSSSSSSSSSSSSSWFFEFFWSSSSSSSSSSSSSSSSSSSSSSSSSSSS
SSSSSSSSSSSSSSSSSSSSSSSSSSSSSSSSSSSWFFFFFWSSSSSSSSSSSSSSSSSSSSSSSSSSSS
SSSSSSSSSSSSSSSSSSSSSSSSSSSSSSSSSSSWFFFFFWSSSSSSSSSSSSSSSSSSSSSSSSSSSS
SSSSSSSSSSSSSSSSSSSSSSSSSSSSSSSSSSSWWFFFWWSSSSSSSSSSSSSSSSSSSSSSSSSSSS
SSSSSSSSSSSSSSSSSSSSSSSSSSSSSSSSSSSSWFFFWSSSSSSSSSSSSSSSSSSSSSSSSSSSSS
SSSSSSSSSSSSSSSSSSSSSSSSSSSSSSSSSSSSWFFFWSSSSSSSSSSSSSSSSSSSSSSSSSSSSS
SSSSSSSSSSSSSSSSSSSSSSSSSSSSSSWWWWWWWFFFWSSSSSSSSSSSSSSSSSSSSSSSSSSSSS
SSSWWWWWWWWSSSSSSSSSSSSSSSSSSSWSSSSSSSFSWSSSSSSSSSSSSSSSSSSSSSSSSSSSSS
SSSWFFFFFFWSSSSSSSSSSSSSSSSSSSWSSSSSSSFSWSSSSSSSSSSSSSSSSSSSSSSSSSSSSS
SSSWFFFFFFWSSSSSSSSSSSSSSSSSSSWSSSFFFFFSWSSSSSSSSSSSSSSSSSSSSSSSSSSSSS
SSSWFFFFFFWSSSSSSSSSSSSSSSSSSSWSSSFSSSSSWSSSSSSSSSSSSSSSSSSSSSSSSSSSSS
SSSWFFFFFFWSSSSSSSSSSSSSSSSSSSWSSSFSSSSSWSSSSSSSSSSSSSSSSSSSSSSSSSSSSS
SSSWHFFFFFWSWWWWWWWWWWWWWWWWWWWWWWDWWWWWWSSSSSSSSSSSSSSSSSSSSSSSSSSSSS
SSSWWWWWWFWSWFFFFFFFFFFHHHWFFFFFFFFFFFWSSSSSSSSSSSSSSSSSSSSSSSSSSSSSSS
SSSSSSSSWFWWWFFFFFFFFFFFHHWFFFFFFFFFFFWSSSSSSSSSSSSSSSSSSSSSSSSSSSSSSS
SSSSSSSSWFFFDFFFFFFFFFFFFFWFFFFFFFFFFHWSSSSSSSSSSSSSSSSSSSSSSSSSSSSSSS
SSSSSSSSWWWWWFFFFFFFFFFFFFWFFFFFFFFFHHWSSSSSSSSSSSSSSSSSSSSSSSSSSSSSSS
SSSSSSSSSSSSWFFFFFFFFFFFFFWFFFFFFFFHHHWSSSSSSSSSSSSSSSSSSSSSSSSSSSSSSS
SSSSSSSSSSSSWHFFFFFFFFFFFFDFFFFFFFHHHHWSSSSSSSSSSSSSSSSSSSSSSSSSSSSSSS
SSSSSSSSSSSSWHHHFFFFFFFFFFWFFFFFFHHHHHWSSSSSSSSSSSSSSSSSSSSSSSSSSSSSSS
SSSSSSSSSSSSWWWWWWWWWWWWWWWWWWWWWWWWWWWSSSSSSSSSSSSSSSSSSSSSSSSSSSSSSS