DEFAULT
4.0,10.0

SSSSSSSSSSSSSSSSSSSSSSSSSSSSSSSSSSSWWWWWWWSSSSSSSSSSSSSSSSSSSSSSSSSSSS
SSSSSSSSSSSSSSSSSSSSSSSSSSSSSSSSSSSWHFFFHWSSSSSSSSSSSSSSSSSSSSSSSSSSSS
SSSSSSSSSSSSSSSSSSSSSSSSSSSSSSSSSSSWFFEFFWSSSSSSSSSSSSSSSSSSSSSSSSSSSS
SSSSSSSSSSSSSSSSSSSSSSSSSSSSSSSSSSSWFFFFFWSSSSSSSSSSSSSSSSSSSSSSSSSSSS
SSSSSSSSSSSSSSSSSSSSSSSSSSSSSSSSSSSWFFFFFWSSSSSSSSSSSSSSSSSSSSSSSSSSSS
SSSSSSSSSSSSSSSSSSSSSSSSSSSSSSSSSSSWWFFFWWSSSSSSSSSSSSSSSSSSSSSSSSSSSS
SSSSSSSSSSSSSSSSSSSSSSSSSSSSSSSSSSSSWFFFWSSSSSSSSSSSSSSSSSSSSSSSSSSSSS
SSSSSSSSSSSSSSSSSSSSSSSSSSSSSSSSSSSSWFFFWSSSSSSSSSSSSSSSSSSSSSSSSSSSSS
SSSSSSSSSSSSSSSSSSSSSSSSSSSSSSWWWWWWWFFFWWWWWWWWWWWWWWWWWWWWWSSSSSSSSS
SSSWWWWWWWWSSSSSSSSSSSSSSSSSSSWSSSSSSSFSSSSSSSSSSSSSSSSSSHHHWSSSSSSSSS
SSSWFFFFFFWSSSSSSSSSSSSSSSSSSSWSSSSSSSFSSSSSSSSSSSSSSSSSSFFFWSSSSSSSSS
SSSWFFFFFFWSSSSSSSSSSSSSSSSSSSWSSSFFFFFSSSSSSSSSSSSSFFFFFFFFWSSSSSSSSS
SSSWFFFFFFWSSSSSSSSSSSSSSSSSSSWSSSFSSSSSSSSSSSSSSSSSSSSSSFFFWSSSSSSSSS
SSSWFFFFFFWSSSSSSSSSSSSSSSSSSSWSSSFSSSSSSSSSSSSSSSSSSSSSSHHHWSSSSSSSSS
SSSWHFFFFFWSWWWWWWWWWWWWWWWWWWWWWWDWWWWWWWWWWWWWWWWWWWWWWWWWWSSSSSSSSS
SSSWWWWWWFWSWFFFFFFFFFFHHHWFFFFFFFFFFFWSSSSSSSSSSSSSSSSSSSSSSSSSSSSSSS
SSSSSSSSWFWWWFFFFFFFFFFFHHWFFFFFFFFFFFWSSSSSSSSSSSSSSSSSSSSSSSSSSSSSSS
SSSSSSSSWFFFDFFFFFFFFFFFFFWFFFFFFFFFFHWSSSSSSSSSSSSSSSSSSSSSSSSSSSSSSS
SSSSSSSSWWWWWFFFFFFFFFFFFFWFFFFFFFFFHHWSSSSSSSSSSSSSSSSSSSSSSSSSSSSSSS
SSSSSSSSSSSSWFFFFFFFFFFFFFWFFFFFFFFHHHWSSSSSSSSSSSSSSSSSSSSSSSSSSSSSSS
SSSSSSSSSSSSWHFFFFFFFFFFFFDFFFFFFFHHHHWSSSSSSSSSSSSSSSSSSSSSSSSSSSSSSS
SSSSSSSSSSSSWHHHFFFFFFFFFFWFFFFFFHHHHHWSSSSSSSSSSSSSSSSSSSSSSSSSSSSSSS
SSSSSSSSSSSSWWWWWWWWWWWWWWWWWWWWWWWWWWWSSSSSSSSSSSSSSSSSSSSSSSSSSSSSSS