TEMPLE
78.0,54.0
55,36;84,30;85,33;82,33;59,35;80,31;56,34;54,33;67,54;79,5;57,24;56,24;56,25;56,26;57,26;58,26;58,28
SSSSSSSSSSSSSSSSSSSSSSSSSSSSSSSSSSSSSSSSSSSSSSSSSSSSSSSSSSSSSSSSSSSSSSSSSSSSSSSWWWSSSSSSSSSSSS
SSSSSSSSSSSSSSSSSSSSSSSSSSSSSSSSSSSSSSSSSSSSSSSSSSSSSSSSSSSSSSSSSSSSSSSSSSSSSSSWFWWWWSSSSSSSSS
SSSSSSSSSSSSSSSSSSSSSSSSSSSSSSSSSSSSSSSSSSSSSSSSSSSSSSSSSSSSSSSSSSSSSSSSSSSSSSSWFFFFWWWSSSSSSS
SSSSSSSSSSSSSSSSSSSSSSSSSSSSSSSSSSSSSSSSSSSSSSSSSSSSSSSSSSSSSSSSSSSSSSSSSSWWWSWWFFHHHFWWWWSSSS
SSSSSSSSSSSSSSSSSSSSSSSSSSSSSSSSSSSSSSSSSSSSSSSSSSSSSSSSSSSSSSSSSSSSSSSSSSWFWWWFFHFHHFFFFWWWSS
SSSSSSSSSSSSSSSSSSSSSSSSSSSSSSSSSSSSSSSSSSSSSSSSSSSSSSSSSSSSSSSSSSSSSSSSWWWFFFFFFFFFFFFFFFFWWS
SSSSSSSSSSSSSSSSSSSSSSSSSSSSSSSSSSSSSSSSSSSSSSSSSSSSSSSSSSSSSSSSSSSSSSSSWFHFFFFFFHHHFHFFFFFFWS
SSSSSSSSSSSSSSSSSSSSSSSSSSSSSSSSSSSSSSSSSSSSSSSSSSSSSSSSSSSSSSSSSSSSSSSSWFFFFHFFHHFFHFHFHHHFWS
SSSSSSSSSSSSSSSSSSSSSSSSSSSSSSSSSSSSSSSSSSSSSSSSSSSSSSSSSSSSSSSSSSSSSSSSWFFHFFFHFHHFFFFFHFFFWS
SSSSSSSSSSSSSSSSSSSSSSSSSSSSSSSSSSSSSSSSSSSSSSSSSSSSSSSSSSSSSSSSSSSSSSWWWHFFFHHFFFHFFHFFFHFHWS
SSSSSSSSSSSSSSSSSSSSSSSSSSSSSSSSSSSSSSSSSSSSSSSSSSSSSSSSSSSSSSSSSSSSSSWFFHHFFFFFHFHFFHHFFFFFWS
SSSSSSSSSSSSSSSSSSSSSSSSSSSSSSSSSSSSSSSSSSSSSSSSSSSSSSSSSSSSSSSSSSSSSSWFFFFFFFHHFFFHFFFFHFFFWS
SSSSSSSSSSSSSSSSSSSSSSSSSSSSSSSSSSSSSSSSSSSSSSSSSSSSSSSSSSSSSSSSSSSSSSWWHHFHFFFHFHHFFHFFFFHFWS
SSSSSSSSSSSSSSSSSSSSSSSSSSSSSSSSSSSSSSSSSSSSSSSSSSSSSSSSSSSSSSSSSSSSSSSWFFFHFFHFFFFHFHFHFFFFWS
SSSSSSSSSSSSSSSSSSSSSSSSSSSSSSSSSSSSSSSSSSSSSSSWWWWWWWWWWWWWWSSSSSSSSSSWFFFFHFHFFFHFFFHFFHFFWS
SSSSSSSSSSSSSSSSSSSSSSSSSSSSSSSSSSSSSSSSSSWWWWWWFFFFPPPPFFFFWWWWWWWSSSSWWFFFFHFFHHFFFFFFFFFHWS
SSSSSSSSSSSSSSSSSSSSSSSSSSSSSSSSSSSSSSSSSSWHHFFFFFFFFFFFFFFFFFFFFFWWSSSSWWWWFHFFFFFFFFFFFFFFWS
SSSSSSSSSSSSSSSSSSSSSSSSSSSSSSSSSSSSSSSSSSWHFFFFFFFFFFFFFFFFFFFFFFFWSSSSSSSWWWWFFFFHFFFFFFFFWS
SSSSSSSSSSSSSSSSSSSSSSSSSSSSSSSSSSSSSSSSSSWFFFFFFFFHWWHFFFFFFFFFFFFWSSSSSSSSSSWWFFFHHHHFFFFFWS
SSSSSSSSSSSSSSSSSSSSSSSSSSSSSSSSSSSSSSSSWWWFFFFFFFFWWWWWWFFFFFFFFFWWSSSSSWWWWWWWFFFFFFHFFFFPWS
SSSSSSSSSSSSSSSSSSSSSSSSSSSSSSSSSSSSSSWWWFFFFFFFFFFWSSSSWFFFHHFFFFWWSSSSSWPPPFFFFFFFFFFFFFFPWS
SSSSSSSSSSSSSSSSSSSSSSSSSSSSSSSSSSSSSSWFFFFFFFFFFFFWSSSSWFFFHFFFFFFWWWWWWWFFFFFFFFFFFFFFFFFFWS
SSSSSSSSSSSSSSSSSSSSSSSSSSSSSSSSWWWWWWWFFFFFFFFFFFFWSSSSWFFFFFFFFFFFFFFFFFFFFFFFFFFFFFFFFFFFWS
SSSSSSSSSSSSSSSSSSSSSSSSSSSSSSSSWFWWFFFFFFFFFFFFFFHWSSSWWFFFFFFFFFFFFFFFFFFFFFFFFFFFFFFFFFFHWS
SSSSSSSSSSSSSSSSSSSSSSSSSSSSSSSSWFFFFFWWWFFFFFFFFFFWWWWWPPPPFFFWWWFFFFFFFFFFFFFFFFFHHFFFFFFHWS
SSSSSSSSSSSSSSSSSSSSSSSSSSSSSSSWWFFFFFWSWFFFFFFFFFFPPPPPPPPPPFWWSWWWWFFFFFFFFFFFFFFHHHFFFFFWWS
SSSSSSSSSSSSSSSSSSSSSSSSSSSSSSSWPFFFFFWWWFFFFFFFFFFFPPPPPPPPWWWSSSSSWFHHHFFFFFFFFFFHHHFFFFFWSS
SSSSSSSSSSSSSSSSSSSSSSSSSSSSSSWWPFFFFFFWWFFFFFFFHHFFPPPPPPFWWSSSSSSSWHHWWWWWWFFFFFFHHHFFFFFWWS
SSSSSSSSSSSSSSSSSSSSSSSSSSSSSSWPPFFFFFFFFFFFFFFFHHHFPPPPPFFWSSSSSSSSWWWWSSSSWWWWWWWWWWFFFFFPWS
SSSSSSSSSSSSSSSSSSSSSSSSSSSSSSWPPHFFFFFFFFFFFFFFFFFFFPWWWWWWSSSSSSSSSSSSSSSSSSSSSSSSSWFFFFFPWS
SSSSSSSSSSSSSSSSSSSSSSSSSSSSSSWWWWWFFFFFFFFFFFFFFFFFFFWWWWWWWWWWWWWWWWWWWWWWWWWWWWWWWWFFFFFPWS
SSSSSSSSSSSSSSSSSSSSSSSSSSSSSSSSSSWFFFFFFFFFFFFFFFFFFFWFFFFPPPPPPPPPPPPPPPPPPPPPPFFFFWFFFFFPWS
SSSSSSSSSSSSSSSSSSSSSSSSSSSSSSSSSSWWWWWFFFFFFWWFFFFFFFWFFFFPPPPPPPPPPPPPPPPPPPPPPFFFFWFFFFFFWS
SSSSSSSSSSSSSSSSSSSSSSSSSSSSSSSSSSSSSSWHFFFFFWWFFFFFFFDFFFFPPPPPPPPPPPPPPPPPPPPPPFFFFDFFFFFFWS
SSSSSSSSSSSSSSSSSSSSSSSSSSSSSSSSSSSSSSWWFFFFFFFFFFFFFFWFFFFPPPPPPPPPPPPPPPPPPPPPPFFFFWFFFFFPWS
SSSSSSSSSSSSSSSSSSSSSSSSSSSSSSSSSSSSSSSWWHFFFFFWWFFFFFWFFFFPPPPPPPPPPPPPPPPPPPPPPFFFWWFFFFFHWS
SSSSSSSSSSSSSSSSSSSSSSSSSSSSSSSSSSSSSSSSWHPPPPWWWFFFFFWWWWWWWWWWWWWWWWWWWWWWWWWWWWWWWWFFFFFWWS
SSSSSSSSSSSSSSSSSSSSSSSSSSSSSSSSSSSSSSSSWHHPWWWSWWWFFFWSSSSSSSSSSSSSSSSSSSSSSSSSSSWWWWFFFFPWSS
SSSSSSSSSSSSSSSSSSSSSSSSSSSSSSSSSSSSSSSSWHHWWSSSSSWFFFWSSSSSSSSSSSSSSSSSSSSSSSSSSWWFFFFFFPWWSS
SSSSSSSSSSSSSSSSSSSSSSSSSSSSSSSSSSSSSSSSWWWWSSSSSSWFFFWSSSSSSSSSSSSSSSSSSSSSSSSSSWFFFFFFHWWSSS
SSSSSSSSSSSSSSSSSSSSSSSSSSSSSSSSSSSSSSSSSSSSSSSSSSWFFFWSWWWSSSSSSSSSSSSSSSSSSSSSSWFFFFFFWWSSSS
SSSSSSSSSSSSSSSSSSSSSSSSSSSSSSSSSSSSSSSSSSSSSSWWWWWPFFWWWHWWWSSSSSSSSSSSSSSSSSSSWWFFFFFWWSSSSS
SSSSSSSSSSSSSSSSSSSSSSSSSSSSSSSSSSSSSSSSSSSSSSWFFFFPPFFFFFFFWWWWSSSSSSSSSSSSSSSWWFFFFFWWSSSSSS
SSSSSSSSSSSSSSSSSSSSSSSSSSSSSSSSSSSSSSSSSSSSSSWFHWWPPFFFFFFFFFFWWSSSSSSSSSSSSSWWHFFFFFWSSSSSSS
SSSSSSSSSSSSSSSSSSSSSSSSSSSSSSSSSSSSSSSSSSSSSSWFFWWFFFFFFFFFFFFFWWSSSSSSSSSSSSWFFFFFFFWSSSSSSS
SSSSSSSSSSSSSSSSSSSSSSSSSSSSSSSSSSSSSSSSSSSSSSWFFWWFFFFFFFFFFFFFFWWSSSSSSSSSSSWFFFFFFFWSSSSSSS
SSSSSSSSSSSSSSSSSSSSSSSSSSSSSSSSSSSSSSSSSSSSSSWFFWWFFFFFFFFFFFFFFFWWSSSSSSSSSWWFFFFFFFWSSSSSSS
SSSSSSSSSSSSSSSSSSSSSSSSSSSSSSSSSSSSSSSSSSSSSSWWFFFFFFFFFFFFFFFFFFFWSSSSSSSSSWFFFFFFHWWSSSSSSS
SSSSSSSSSSSSSSSSSSSSSSSSSSSSSSSSSSSSSSSSSSSSSSSWWFFHFFFFFFFFFFFFFHWWSSSSSSSSSWFFFFFWWWSSSSSSSS
SSSSSSSSSSSSSSSSSSSSSSSSSSSSSSSSSSSSSSSSSSSSSSSSWWWWPFFFFFFFFFFFFWWSSSSSSSWWWWFFFFFWSSSSSSSSSS
SSSSSSSSSSSSSSSSSSSSSSSSSSSSSSSSSSSSSSSSSSSSSSSSSSSWPPFFFFFFFFFFFWSSSSSSSWWFFFFFFFFWSSSSSSSSSS
SSSSSSSSSSSSSSSSSSSSSSSSSSSSSSSSSSSSSSSSSSSSSSSSSSSWPPHFFFFFFFFFFWWWWWSWWWFFFFFFFFFWSSSSSSSSSS
SSSSSSSSSSSSSSSSSSSSSSSSSSSSSSSSSSSSSSSSSSSSSSSSSSSWPPHFFFFFFFFFFFFFFWWWPPFFFFFFFFFWSSSSSSSSSS
SSSSSSSSSSSSSSSSSSSSSSSSSSSSSSSSSSSSSSSSSSSSSSSSSSSWWWHFFFFFFFFFFFFFFPPPPPFFFFFFFFFWSSSSSSSSSS
SSSSSSSSSSSSSSSSSSSSSSSSSSSSSSSSSSSSSSSSSSSSSSSSSSSSSWWWWFFFWWFFEFFFFPPPPPFFFFFFFFWWSSSSSSSSSS
SSSSSSSSSSSSSSSSSSSSSSSSSSSSSSSSSSSSSSSSSSSSSSSSSSSSSSSSWWWWWWFFFFFFFPPPPPFFFFFFWWWSSSSSSSSSSS
SSSSSSSSSSSSSSSSSSSSSSSSSSSSSSSSSSSSSSSSSSSSSSSSSSSSSSSSSSSSSWWFFFFFFPWWWWWHFWWWWSSSSSSSSSSSSS
SSSSSSSSSSSSSSSSSSSSSSSSSSSSSSSSSSSSSSSSSSSSSSSSSSSSSSSSSSSSSSWWWWWWWWWSSSWWWWSSSSSSSSSSSSSSSS