TEMPLE
55.0,15.0

SSSSSSSSSSSSSSSSSSSSSSSSSSSSSSSSSSSSSSSSSSSSSSSSSSSSSSSSSSSSSSSSSSSSSSSSSSSSSSSWWWSSSSSSSSSSSS
SSSSSSSSSSSSSSSSSSSSSSSSSSSSSSSSSSSSSSSSSSSSSSSSSSSSSSSSSSSSSSSSSSSSSSSSSSSSSSSWFWWWWSSSSSSSSS
SSSSSSSSSSSSSSSSSSSSSSSSSSSSSSSSSSSSSSSSSSSSSSSSSSSSSSSSSSSSSSSSSSSSSSSSSSSSSSSWFFFFWWWSSSSSSS
SSSSSSSSSSSSSSSSSSSSSSSSSSSSSSSSSSSSSSSSSSSSSSSSSSSSSSSSSSSSSSSSSSSSSSSSSSWWWSWWFFHHHFWWWWSSSS
SSSSSSSSSSSSSSSSSSSSSSSSSSSSSSSSSSSSSSSSSSSSSSSSSSSSSSSSSSSSSSSSSSSSSSSSSSWFWWWFFHFHHFFFFWWWSS
SSSSSSSSSSSSSSSSSSSSSSSSSSSSSSSSSSSSSSSSSSSSSSSSSSSSSSSSSSSSSSSSSSSSSSSSWWWFFFFFFFFFFFFFFFFWWS
SSSSSSSSSSSSSSSSSSSSSSSSSSSSSSSSSSSSSSSSSSSSSSSSSSSSSSSSSSSSSSSSSSSSSSSSWFHFFFFFFHHHFHFFFFFFWS
SSSSSSSSSSSSSSSSSSSSSSSSSSSSSSSSSSSSSSSSSSSSSSSSSSSSSSSSSSSSSSSSSSSSSSSSWFFFFHFFHHFFHFHFHHHFWS
SSSSSSSSSSSSSSSSSSSSSSSSSSSSSSSSSSSSSSSSSSSSSSSSSSSSSSSSSSSSSSSSSSSSSSSSWFFHFFFHFHHFFFFFHFFFWS
SSSSSSSSSSSSSSSSSSSSSSSSSSSSSSSSSSSSSSSSSSSSSSSSSSSSSSSSSSSSSSSSSSSSSSWWWHFFFHHFFFHFFHFFFHFHWS
SSSSSSSSSSSSSSSSSSSSSSSSSSSSSSSSSSSSSSSSSSSSSSSSSSSSSSSSSSSSSSSSSSSSSSWFFHHFFFFFHFHFFHHFFFFFWS
SSSSSSSSSSSSSSSSSSSSSSSSSSSSSSSSSSSSSSSSSSSSSSSSSSSSSSSSSSSSSSSSSSSSSSWFFFFFFFHHFFFHFFFFHFFFWS
SSSSSSSSSSSSSSSSSSSSSSSSSSSSSSSSSSSSSSSSSSSSSSSSSSSSSSSSSSSSSSSSSSSSSSWWHHFHFFFHFHHFFHFFFFHFWS
SSSSSSSSSSSSSSSSSSSSSSSSSSSSSSSSSSSSSSSSSSSSSSSSSSSSSSSSSSSSSSSSSSSSSSSWFFFHFFHFFFFHFHFHFFFFWS
SSSSSSSSSSSSSSSSSSSSSSSSSSSSSSSSSSSSSSSSSSSSSSSWWWWWWWWWWWWWWSSSSSSSSSSWFFFFHFHFFFHFFFHFFHFFWS
SSSSSSSSSSSSSSSSSSSSSSSSSSSSSSSSSSSSSSSSSSWWWWWWFFFFFFFFFFFFWWWWWWWSSSSWWFFFFHFFHHFFFFFFFFFHWS
SSSSSSSSSSSSSSSSSSSSSSSSSSSSSSSSSSSSSSSSSSWFFFFFFFFFFFFFFFFFFFFFFFWWSSSSWWWWFHFFFFFFFFFFFFFFWS
SSSSSSSSSSSSSSSSSSSSSSSSSSSSSSSSSSSSSSSSSSWFFFFFFFFFFFFFFFFFFFFFFFFWSSSSSSSWWWWFFFFHFFFFFFFFWS
SSSSSSSSSSSSSSSSSSSSSSSSSSSSSSSSSSSSSSSSSSWFFFFFFFFHWWHFFFFFFFFFFFFWSSSSSSSSSSWWFFFHHHHFFFFFWS
SSSSSSSSSSSSSSSSSSSSSSSSSSSSSSSSSSSSSSSSWWWFFFFFFFFWWWWWWFFFFFFFFFWWSSSSSWWWWWWWFFFFFFHFFFFFWS
SSSSSSSSSSSSSSSSSSSSSSSSSSSSSSSSSSSSSSWWWFFFFFFFFFFWSSSSWFFFHHFFFFWWSSSSSWFFFFFFFFFFFFFFFFFFWS
SSSSSSSSSSSSSSSSSSSSSSSSSSSSSSSSSSSSSSWFFFFFFFFFFFFWSSSSWFFFHFFFFFFWWWWWWWFFFFFFFFFFFFFFFFFFWS
SSSSSSSSSSSSSSSSSSSSSSSSSSSSSSSSWWWWWWWFFFFFFFFFFFFWSSSSWFFFFFFFFFFFFFFFFFFFFFFFFFFFFFFFFFFFWS
SSSSSSSSSSSSSSSSSSSSSSSSSSSSSSSSWFWWFFFFFFFFFFFFFFHWSSSWWFFFFFFFFFFFFFFFFFFFFFFFFFFFFFFFFFFHWS
SSSSSSSSSSSSSSSSSSSSSSSSSSSSSSSSWFFFFFWWWFFFFFFFFFFWWWWWFFFFFFFWWWFFFFFFFFFFFFFFFFFHHFFFFFFHWS
SSSSSSSSSSSSSSSSSSSSSSSSSSSSSSSWWFFFFFWSWFFFFFFFFFFFFFFFFFFFFFWWSWWWWFFFFFFFFFFFFFFHHHFFFFFWWS
SSSSSSSSSSSSSSSSSSSSSSSSSSSSSSSWFFFFFFWWWFFFFFFFFFFFFFFFFFFFWWWSSSSSWFFFFFFFFFFFFFFHHHFFFFFWSS
SSSSSSSSSSSSSSSSSSSSSSSSSSSSSSWWFFFFFFFWWFFFFFFFHHFFFFFFFFFWWSSSSSSSWFFFFFFFFFFFFFFHHHFFFFFWWS
SSSSSSSSSSSSSSSSSSSSSSSSSSSSSSWFFFFFFFFFFFFFFFFFHHHFFFFFFFHWSSSSSSSSWFFFHHHHFFFFHFWWWWFFFFFFWS
SSSSSSSSSSSSSSSSSSSSSSSSSSSSSSWFFHFFFFFFFFFFFFFFFFFFFFWWWWWWSSSSSSSSWWFFHHHFFFFWWWWSSWFFFFFFWS
SSSSSSSSSSSSSSSSSSSSSSSSSSSSSSWWWWWFFFFFFFFFFFFFFFFFFFWSSSSSSSSSSSSSSWWFHWWWFFWWSSSSSWFFFFFFWS
SSSSSSSSSSSSSSSSSSSSSSSSSSSSSSSSSSWFFFFFFFFFFFFFFFFFFFWSSSSSSSSSSSSSSSWWWWSWWWWSSSSSSWFFFFFFWS
SSSSSSSSSSSSSSSSSSSSSSSSSSSSSSSSSSWWWWWFFFFFFWWFFFFFFFWSSSSSSSSSSSSSSSSSSSSSSSSSSSSSSWFFFFFFWS
SSSSSSSSSSSSSSSSSSSSSSSSSSSSSSSSSSSSSSWHFFFFFWWFFFFFFFWSSSSSSSSSSSSSSSSSSSSSSSSSSSSSSWFFFFFFWS
SSSSSSSSSSSSSSSSSSSSSSSSSSSSSSSSSSSSSSWWFFFFFFFFFFFFFFWSSSSSSSSSSSSSSSSSSSSSSSSSSSSSSWFFFFFFWS
SSSSSSSSSSSSSSSSSSSSSSSSSSSSSSSSSSSSSSSWWHFFFFFWWFFFFFWSSSSSSSSSSSSSSSSSSSSSSSSSSSSSWWFFFFFHWS
SSSSSSSSSSSSSSSSSSSSSSSSSSSSSSSSSSSSSSSSWHFFFFWWWFFFFFWSSSSSSSSSSSSSSSSSSSSSSSSSSSSSWFFFFFFWWS
SSSSSSSSSSSSSSSSSSSSSSSSSSSSSSSSSSSSSSSSWHHFWWWSWWWFFFWSSSSSSSSSSSSSSSSSSSSSSSSSSSWWWFFFFFFWSS
SSSSSSSSSSSSSSSSSSSSSSSSSSSSSSSSSSSSSSSSWHHWWSSSSSWFFFWSSSSSSSSSSSSSSSSSSSSSSSSSSWWFFFFFFFWWSS
SSSSSSSSSSSSSSSSSSSSSSSSSSSSSSSSSSSSSSSSWWWWSSSSSSWFFFWSSSSSSSSSSSSSSSSSSSSSSSSSSWFFFFFFHWWSSS
SSSSSSSSSSSSSSSSSSSSSSSSSSSSSSSSSSSSSSSSSSSSSSSSSSWFFFWSWWWSSSSSSSSSSSSSSSSSSSSSSWFFFFFFWWSSSS
SSSSSSSSSSSSSSSSSSSSSSSSSSSSSSSSSSSSSSSSSSSSSSWWWWWFFFWWWHWWWSSSSSSSSSSSSSSSSSSSWWFFFFFWWSSSSS
SSSSSSSSSSSSSSSSSSSSSSSSSSSSSSSSSSSSSSSSSSSSSSWFFFFFFFFFFFFFWWWWSSSSSSSSSSSSSSSWWFFFFFWWSSSSSS
SSSSSSSSSSSSSSSSSSSSSSSSSSSSSSSSSSSSSSSSSSSSSSWFHWWFFFFFFFFFFFFWWSSSSSSSSSSSSSWWHFFFFFWSSSSSSS
SSSSSSSSSSSSSSSSSSSSSSSSSSSSSSSSSSSSSSSSSSSSSSWFFWWFFFFFFFFFFFFFWWSSSSSSSSSSSSWFFFFFFFWSSSSSSS
SSSSSSSSSSSSSSSSSSSSSSSSSSSSSSSSSSSSSSSSSSSSSSWFFWWFFFFFFFFFFFFFFWWSSSSSSSSSSSWFFFFFFFWSSSSSSS
SSSSSSSSSSSSSSSSSSSSSSSSSSSSSSSSSSSSSSSSSSSSSSWFFWWFFFFFFFFFFFFFFFWWSSSSSSSSSWWFFFFFFFWSSSSSSS
SSSSSSSSSSSSSSSSSSSSSSSSSSSSSSSSSSSSSSSSSSSSSSWWFFFFFFFFFFFFFFFFFFFWSSSSSSSSSWFFFFFFHWWSSSSSSS
SSSSSSSSSSSSSSSSSSSSSSSSSSSSSSSSSSSSSSSSSSSSSSSWWFFHFFFFFFFFFFFFFHWWSSSSSSSSSWFFFFFWWWSSSSSSSS
SSSSSSSSSSSSSSSSSSSSSSSSSSSSSSSSSSSSSSSSSSSSSSSSWWWWFFFFFFFFFFFFFWWSSSSSSSWWWWFFFFFWSSSSSSSSSS
SSSSSSSSSSSSSSSSSSSSSSSSSSSSSSSSSSSSSSSSSSSSSSSSSSSWFFFFFFFFFFFFFWSSSSSSSWWFFFFFFFFWSSSSSSSSSS
SSSSSSSSSSSSSSSSSSSSSSSSSSSSSSSSSSSSSSSSSSSSSSSSSSSWFFHFFFFFFFFFFWWWWWSWWWFFFFFFFFFWSSSSSSSSSS
SSSSSSSSSSSSSSSSSSSSSSSSSSSSSSSSSSSSSSSSSSSSSSSSSSSWFFHFFFFFFFFFFFFFFWWWFFFFFFFFFFFWSSSSSSSSSS
SSSSSSSSSSSSSSSSSSSSSSSSSSSSSSSSSSSSSSSSSSSSSSSSSSSWWWHFFFFFFFFFFFFFFFFFFFFFFFFFFFFWSSSSSSSSSS
SSSSSSSSSSSSSSSSSSSSSSSSSSSSSSSSSSSSSSSSSSSSSSSSSSSSSWWWWFFFWWFFEFFFFFFFFFFFFFFFFFWWSSSSSSSSSS
SSSSSSSSSSSSSSSSSSSSSSSSSSSSSSSSSSSSSSSSSSSSSSSSSSSSSSSSWWWWWWFFFFFFFFFFFFFFFFFFWWWSSSSSSSSSSS
SSSSSSSSSSSSSSSSSSSSSSSSSSSSSSSSSSSSSSSSSSSSSSSSSSSSSSSSSSSSSWWFFFFFFFWWWWWHFWWWWSSSSSSSSSSSSS
SSSSSSSSSSSSSSSSSSSSSSSSSSSSSSSSSSSSSSSSSSSSSSSSSSSSSSSSSSSSSSWWWWWWWWWSSSWWWWSSSSSSSSSSSSSSSS
