TEMPLE
66.0,3.0
48,18;72,12;73,15;70,15;52,17;68,13;49,16;47,15;55,4;96,6;82,13;59,30;58,30;57,30;56,30;56,29;55,29;55,28;78,20;86,22;81,27;74,25;63,27;55,22;48,23;46,28;37,27;35,22;43,22;40,16;44,9;49,6;31,15;49,5;
SSSSSSSSSSSSSSSSSSSSSSSSSSSSSSSSSSSSSSSSSSSSSSSSSSWWWWWWWWSSWWWWWWWWWWSSSSSSSSSSSSSSSSSSSSSSSSSSSSSSS
SSSSSSSSSSSSSSSSSSSSSSSSSSSSSSSSSSSSSSSSSSSSSSSSWWWFFFFFFWWWWPPPFFFFFWWWWSSSSSSSSSSSSSSSSSSSSSSSSSSSS
SSSSSSSSSSSSSSSSSSSSSSSSSSSSSSSSSSSSSSSSSSSSSSSWWFFFFFFFFPPPPPPPFFFFFFFHWWSSSSSSSSSSSSSSSSSSSSSSSSSSS
SSSSSSSSSSSSSSSSSSSSSSSSSSSSSSSSSSSSSSSSSSSSSWWWHFFFFFFFFPPPPPPPFFFFFFFFHWWSSSSSSSSSSSSSSSSSSSSWWWWWS
SSSSSSSSSSSSSSSSSSSSSSSSSSSSSSSSSSSSSSSSSSSSWWFFFFEFFFFFFPPPPPPPFFFFFFFFFFWWSWWWSSSSSSSSSSSSWWWWFFFWS
SSSSSSSSSSSSSSSSSSSSSSSSSSSSSSSSSSSSSSSSSSSWWHFFFFFFFFFFFPPPPPPPFFFFFFFFFFFWWWPWWSSSSSSSSSSWWFFFFHFWW
SSSSSSSSSSSSSSSSSSSSSSSSSSSSSSSSSSSSSSSSSWWWFFFFFFFFFFFFHWWWWWWWWFFFFFFFFFFFFFPPWWSSSSSSSWWWFFFFFHFPW
SSSSSSSSSSSSSSSSSSSSSSSSSSSSSSSSSSSSSSSSSWPFFFFFFFFFFHHWWWSSSSSSWWFFFFFFFFFFFFFPPWWSSSSWWWFFFFFHFFFPW
SSSSSSSSSSSSSSSSSSSSSSSSSSSSSSSSSSSSSSSSSWFFFFFFFFFHFWWWSSSSSSSSSWWWPPFFFFFFFFFFFFWSSSWWFFFHFHFFHHFPW
SSSSSSSSSSSSSSSSSSSSSSSSSSSSSSSSSSSSSSSSSWFFFFFFFFFWWWSSSSSSSSSSSSSWWWWWFFFFFFFFFFWWWWWHHHFFHHFFFFFFW
SSSSSSSSSSSSSSSSSSSSSSSSSSSSWWWWSSWWWWWWWWFFFFFHWWWWSSSSSSSSSSSSSSSSSSSWWFFFFFFFFFFHPFFFPHFFFPPFFHFFW
SSSSSSSSSSSSSSSSSSSSSSSSSSSWWPPWWWWPPFFFFFFFFFFWWSSSSSSSSSSSSSSSSSSSSSSSWWFFFFFFFFHFFFFHPPPHFHFHHFFHW
SSSSSSSSSSSSSSSSSSSSSSSSSSSWPPFFFFFFFFFFFFFFFFFWWWWWWWWWWWWWWWWWWWWWWWWWWWFFFFFFFFHFFFFHFHHFFPHFFHFPW
SSSSSSSSSSSSSSSSSSSSSSSSSSSWPPFFFFFFFFFFFFFFFFFWFFFFPPPPPPPPPPPPPPPPPFFFFWFFFFFFFFFFFHFFFHHFFHHHFHPPW
SSSSSSSSSSSSSSSSSSSSSSSSSSSWFFFFFFFFFFFFFFFFFFFWFFFFPPPPPPPPPPPPPPPPPFFFFWFFFFFFFFFHFHHFFFFFHHPPFFPWW
SSSSSSSSSSSSSSSSSSSSSSSSSSSWFFFFFFFWWFFFFFFFFFFDFFFFPPPPPPPPPPPPPPPPPFFFFDFFFFFFFWWHFFFFHFFFFPPPWWWWS
SSSSSSSSSSSSSSSSSSSSSSSSSSSWFFFFFFFWWFFFFFFFFFFWFFFFPPPPPPPPPPPPPPPPPFFFFWFFFFFFWWWWPPFFHFHHPPWWWSSSS
SSSSSSSSSSSSSSSSSSSSSSSSSSSWFFFFFFFFFFFFFFFFFFFWFFFFPPPPPPPPPPPPPPPPPFFFFWFFFFFFWSSWPHHFFWWWWWWSSSSSS
SSSSSSSSSSSSSSSSSSSSSSSSSSSWWFFHHFFFFFFFFFFFFFFWWWWWWWWWWWWWWWWWWWWWWWWWWWFFFFFWWSSWWFFFFWSSSSSSSSSSS
SSSSSSSSSSSSSSSSSSSSSSSSSSSSWWHFHFFFFFFFFFFFFFFWSSSSSSSSSSSSSSSSSSSSSSSWWWFFFFFWSSSSWFFFHWWWSSSSSSSSS
SSSSSSSSSSSSSSSSSSSSSSSSSSSSSWWFFFFFFFFFFFFFFFFWWWSSSSWWWWWSSSSSSSSSSSSWWPFFFFFWWWSSWHHFHFFWSSSSSSSSS
SSSSSSSSSSSSSSSSSSSSSSSSSSSSWWWFFFFFFFFFFFFFFFFHHWWWWWWFFFWWWSSSSSSSSSSWPPFFFFFFFWSSWFFFFFHWSSSSSSSSS
SSSSSSSSSSSSSSSSSSSSSSSSSSSSWPPFFFFFFFFFFFFFFFFFFFFFFFFFFFFFWWSSSSSSSSSWPFFFFFFFFWWWWFFFFFFWSSSSSSSSS
SSSSSSSSSSSSSSSSSSSSSSSSSSSSWPPFFFFFFFFHFFFFFFFFFFFFFFFFFFFFFWWSSSSSSSSWFFFFFFFFFFFFFFFFFFFWSSSSSSSSS
SSSSSSSSSSSSSSSSSSSSSSSSSSSSWWPFFFFFFFFFFFFFFFFFFFFFFFWWWWFFFHWWSSSSSSWWFFFFFFFFFFFFFFFFFFFWWWSSSSSSS
SSSSSSSSSSSSSSSSSSSSSSSSSSSSSWWFFFFFFFFFHHFFFFFFFFFFFWWSSWFFFFFWWSSSSSWFFFFFFFFFFHFFFFFPPFFFFWSSSSSSS
SSSSSSSSSSSSSSSSSSSSSSSSSSSSSSWFFFFFFFFFFHFFFFFFFFFFFWSSSWWFFFFFWWWWWWWFFFFFFFFHFFFFFFPPPFFFFWSSSSSSS
SSSSSSSSSSSSSSSSSSSSSSSSSSSSSSWFFFFFFFFFFFFFFFFFFFFFFWWWWWWFFFFFFFFFFFFFFFFFFFFFFFFFFFPPPFFFWWSSSSSSS
SSSSSSSSSSSSSSSSSSSSSSSSSSSSSSWWPPFFFFFFFFFFHFFFFFFFPWWFWWFFFFFFFFFFFFFFFFFFFFFFFFFFFFPPFFFFWSSSSSSSS
SSSSSSSSSSSSSSSSSSSSSSSSSSSSSSSWPPPFPFFFWWWWHHHFFFFPPPPPPPPFFFFFFHFFFFFFFFFFFHHFFFFFFFFFFFFFWSSSSSSSS
SSSSSSSSSSSSSSSSSSSSSSSSSSSSSSSWWPWWPWWWWSSWHHHFFFPPPPPPPPPPFFFFHHWWPPFFFFFHHHHHFFWWWWWWFFFFWSSSSSSSS
SSSSSSSSSSSSSSSSSSSSSSSSSSSSSSSSWWWWWWSSSSSWWWWWWWWPPPPPPPPPWWWWWWWWWWWWWWWWWWWWWWWSSSSWWWWWWSSSSSSSS
SSSSSSSSSSSSSSSSSSSSSSSSSSSSSSSSSSSSSSSSSSSSSSSSSSWWWWWWWWWWWSSSSSSSSSSSSSSSSSSSSSSSSSSSSSSSSSSSSSSSS