FOREST
25.790197,64.45199
30,73;51,70;30,76;51,67;27,73;26,73;49,72;52,72;53,75;56,69;54,74;54,71;57,72;9,27;13,27;46,26;48,47;83,38;85,37;87,15;86,13;21,16;92,62;91,58;50,56;4,65;7,60;3,58;3,48;5,35;9,41;18,41;17,35;26,36;32,34;39,35;48,34;56,44;65,29;67,36;65,47;79,57;59,57;55,63;68,72;81,69;76,24;76,17;61,9;49,8;38,7;31,10;23,9;22,7;21,6;
SSSSSSSSSSSSSSSWWWWWWWSSSSSSSSSSSSSSSWWWWWWWWWSSSSSSSSSSSSSSSSSSSSSSSSSSSSSSSSSSSSSSSSSSSSSSSSSSSSSSSSSS
SSSSSSSSSSSSSSWWFFFFFWWWSSSSSSSSSSSSWWFFFFFFFWWWWWWWWWWWWWSSSSSSSSSSSSSSSSSSSSSSSSSSSSSSSSSSSSSSSSSSSSSS
SSSSSSSSSSSSSSWFFFFFFFFWWSSSSSSSSSSSWFFFFFFFFFFFFFFFFFFFFWWWWWWSSSSSSSSSSSSSSSSSSSSSSSSSSSSSSSSSSSSSSSSS
SSSSSSSSSSSSSWWFFFFFFFFFWWWSSSSSSSSWWFFFFFFFFFFFFFFFFFFFFFFFFFWWWWSSSSSSSSSSSSSSSSSSSSSSSSSSSSSSSSSSSSSS
SSSSSSSSSSSSSWFFFFFFFFFFFFWWSSSSSSSWFFFFFFFFFFFFFFFFFFFFFFFFFFFFFWWWWWSSSSSSSSSSSSSSSSSSSSSSSSSSSSSSSSSS
SSSSSSSSSSSSSWFFFFFFFFFFFFFWWWSSSWWWFFFFFFFFFFFFFFFFFFFFFFFFFFFFFFFFFWWWSSSSSSSSSSSSSSSSSSSSSSSSSSSSSSSS
SSSSSSSSSSSSSWFFFFEFFFFFFFFFFWWWWWFFFFFFFFFFFFFFFFFFFFFFFFFFFFFFFFFFFFFWWSSSSSSSSSSSSSSSSSSSSSSSSSSSSSSS
SSSSSSSSSSSSSWFFFFFFFFFFFFFFFFFFFFFFFFFFFFFFFFFFFFFFFFFFFFFFFFFFFFFFFFFFWWWSSSSSSSSSSSSSSSSSSSSSSSSSSSSS
SSSSSSSSSSSSSWFFFFFFFFFFFFFFFFFFFFFFFFFFFFFFFFFFFFFFFFFFFFFFFFFFFFFFFFFFFFWWSSSSSSSSSSSSSSSSSSSSSSSSSSSS
SSSSSSSSSSSSSWFFFFFFFFFFFFFFFFFFFFFFFFFFFFFFFFFFFFFFFFFFFFFFFFFFFFFFFFFFFFFWWSSSSSSSSSSSSSSSSSSSSSSSSSSS
SSSSSSSSSSSSSWFFFFFFFFFFFFFFFFFFFFFFFFFFFFFFFFFFFFFFFFFFFFFFFFFFFFFFFFFFFFFFWWWWWSSSSWWWWWWWSSSSSSSSSSSS
SSSSSSSSSSSSSWFFFFFFFFFFFFFFFFFFFFFFFFFFFFFFFFFFFFFFFFFFFFFFFFFFFFFFFFFFFFFFFFFFWSSWWWFFFFFWWWSSSSSSSSSS
SSSSSSSSSSSSSWFFFFFFFFFFFFFWWFFFFFFFFFFFFFFFFFFFFFFFFFFFFFFFFFFFFFFFFFFFFFFFFFFFWWSWFFFFFFFHFWSSSSSSSSSS
SSSSSSSSSSSSSWWWFFFWWFFFFFFWWFFFFFFFFFWWWWWWWWFFFFFFFFFFFFFFFFFFFFFFFFFFFFFFFFFFFWSWFFFFFFFFFWSSSSSSSSSS
SSSSSSSSSSSSSSSWFFWWWFFFFFFFFFFFFFFFFWWSSSSSSWWWWWWWWWWWFFFFFFFFFFFFFFFWWWFFFFFFFWWWFFFFFFFFFWSSSSSSSSSS
SSSSSSSSSSSSSSSWFWWWFFFFFFFFFFFFFFFWWWSSSSSSSSSSSSSSSSSWWWWWWWWWWWFFFFFWWWFFFFFFFFFFFFFFFFFHFWSSSSSSSSSS
SSSSSSSSSSSSSSSWWWWFFFFFFFFFFFFFFWWWSSSSSSSSSSSSSSSSSSSSSSSSSSSSSWWFFFFWWFFFFFFFFFFFFFFFFFFFFWSSSSSSSSSS
SSSSSSSSSSSSSSSSSSWFFFFFFFFFFFFFWWSSSSSSSSSSSSSSSSSSSSSSSSSSSSSSSSWFFFFFFFFFFFFFFFFFFFFFWWWWWWSSSSSSSSSS
SSSSSSSSSSSSSSSSSSWWWWWWWFFFFFWWWSSSSSSSSSSSSSSSSSSSSSSSSSSSSSSSSSWFFFFFFFFFFFFFFFFFFFFFWSSSSSSSSSSSSSSS
SSSSSSSSSSSSSSSSSSSSSSSSWWWWWWWSSSSSSSSSSSSSSSSSSSSSSSSSSSSSSSSSSSWWFFFFFFFFFFFFFFFFFFFFWSSSSSSSSSSSSSSS
SSSSSSSSSSSSSSSSSSSSSSSSSSSSSSSSSSSSSSSSSSSSSSSSSSSSSSSSSSSSSSSSSSSWFFFFFFFFFFFFFFFFFFHWWSSSSSSSSSSSSSSS
SSSSSSSSSSSSSSSSSSSSSSSSSSSSSSSSSSSSSSSSSSSSSSSSSSSSSSSSSSWWWWWSSSSWFFFFFFFFFFFFFFFFFFFWSSSSSSSSSSSSSSSS
SSSSSSSSSSSSSSSSSSSSSSSSSSSSSSSSSSSSSSSSSSSSSSSSSSSSSSSSSWWFFFWSWWWWHFFHFFFFFFFFFFFFFFWWSSSSSSSSSSSSSSSS
SSSSSSSSSWWWWWWSSSSSSSSSSSSSSSSSSSSSSSSSSSSSWWWWWSSSSSSSSWFFFFWWWFFFFFFFFFFFFFFFFFFFHHWSSSSSSSSSSSSSSSSS
SSSSSSSSWWFFFFWSSSSSSSSSSSSSSSSSSSSSSSSSSSSSWFFFWWWSSSSSSWFFFFFFHFFHFFFFFFFFFFFFFFFFFFWSSSSSSSSSSSSSSSSS
SSSSSSWWWFFFFFWWWSSSSSSSSSSSSSSSSSSSSSSSSSSWWFFFFFWSSSSSSWFFFHHFFFFFFFFFFFFFFFFFFFFFFFWWSSSSSSSSSSSSSSSS
SSSSSSWFFFFFFFFFWSSSSSSSSSSSSSSSSSSSSSSSWWWWFFFFFFWSSSSSWWFFHFFFFFFFFFFFFFFFFFFFFFFFFFFWWWSSSSSSSSSSSSSS
SSSSSSWFFFFFFFFFWSSSSSSSSSSSSSSSSSSSWWWWWFFFFFFFFFWWWWSSWFFFFFFFFFFFFFFFFFFFFFFFFFFFFFFFFWWSSSSSSSSSSSSS
SSSSWWWFFFFFFFFFWSSSSSSSSSSSWWWWWSSSWFFFFFFFFFFFFFFFFWSWWFFFFFFFFFFFFFFFFFFFFFFFFFFFFFFFFFWSSSSSSSSSSSSS
SWWWWFFFFFFFFFFFWWWSSSSSSSWWWFFFWWSSWFFFFFFFFFFFFFFFFWWWPPFFFFFFFFFFFFFFFFFFFFFFFFFFFFFFFFWSSSSSSSSSSSSS
SWFFFFFFFFFFFFFFFFWSSSSSSWWFFFFFFWWWWFFFFFFFFFFFFFFFFFPPPPPFFFFFFFFFFFFFFFFFFFFFFFFFFFFFHWWSSSSSSSSSSSSS
SWFFFFFFFFFFFFFFFFWWSSSSSWFFFFFFFFFFFFFFFFFFFFFFFFFFFFPPPPPFFFFFFFFFFFFFFFFWWFFFFFFFFFFFFWSSSSSSSSSSSSSS
SWFFFFFFFFFFFFFFFFFWWSSSWWFFFFFFFFFFFFFFFFFFFFFFFFFFFFFPPPPPFFFFFFFFFFFFFFFWWFFFFFFFFFFFFWWSSSSSSSSSSSSS
SWFFFFFFFFFFFFFFFFFFWWWWWFFFFFFFFFFFFFFFFFFFFFFFFFFFFFFPPPPPFFFFFFFFFFFFFFFWWFFFFFFFFFFFFFWSSSSSSSSSSSSS
SWFFFFFFFFFWWFFFFFFFFFFFFFFFFFFFFFFFFFFFFFFFFFFFFFFFFFFFPPPWWFFFFFFFFFFFFFFWWWWFFFFFFFFFFFWSSSSSSSSSSSSS
SWFFFFFFFFWWWFFFFFFFFFFFFFFFFFFFFFFFFFFFFFFFFFFFFFFFFFFFWWWWWFFFFFFFFFFFFFWWWWWFFFFFFFFFHWWSSSSSSSSSSSSS
SWFFFFFFFFWWWFFFFFFFFFFFFFFFFFFFFFFFFFFFFFFFFFFFFFFFFFFFWWSSWFFFFFFFFFFFFFWWFFFFFFFFFFFFFWSSSSSSSSSSSSSS
SWFFFFFFFFFWWFFFFFFFFFFFFFFFFFFFFFFFFFFFFFFFFFFFFFFFFFFFFWSSWFFFFFFFFFFFFFFFFFFFFFFFFFFFFWSSSSSSSSSSSSSS
SWFFFFFFFFFWWFFFFFFFFFFFFFFFFFFFFFFFFFFFFFFFFFFFFFFFFFFFHWSSWFHFFFFFFFFFFFFFFFFFFFFFFFFFWWSSSSSSSSSSSSSS
SWFFFFFFFFFWWFFFFFFFFFFFFFFFFFFFWWWFFFFFFFFFFFFFFFFFFFFFFWWWWFFFFFFFFFFFFFFFFFFFFFFFFFFWWSSSSSSSSSSSSSSS
SWFFFFFFFFFFFFFFFFFFFFFFFFFFFFFWWSWWFFFFFFFFFFFFFWWWFFFFHFFWWFFFFFFFFFFFFFFFFFFFWWWWFFWWSSSSSSSSSSSSSSSS
SWFFFFFFFFFFFFFFFFFFFFFFFFFFWWWWSSSWWWWFHFFFFFFFFWWWFFFFFFFFFFFFFFFFFFWWWWWWWWWWWSSWFWWSSSSSSSSSSSSSSSSS
SWWFFFFFFFFFFFFFFFFFFFFFFFFFWSSSSSSSSSWWWWHFFFFFFFWWFFFFFFFFFFFFFFFFFFWSSSSSSSSSSSSWWWSSSSSSSSSSSSSSSSSS
SWWFFFFFFFFFFFFFFFFFFFFFFFFFWSSSSSSSSSSSSWFFWWFFFFWWFFFFFFFFFFFFFFFFFFWSSSSSSSSSSSSSSSSSSSSSSSSSSSSSSSSS
SWFFFFFFFFFWWWWFFFFFFFFHFFHFWSSSSSSSSSSSSWWWWWWFFFHFFFFFFFFFFFFFFFFFFFWSSSSSSSSSSSSSSSSSSSSSSSSSSSSSSSSS
SWFFFFFFFFWWSSWFFFFWWWWWWWWWWSSSSSSSSSSSSSSSSSWHFFFFFFFFFFFFFFFFFFFFFFWSSSSSSSSSSSSSSSSSSSSSSSSSSSSSSSSS
SWFFFFFFFFWSSSWWWWWWSSSSSSSSSSSSSSSSSSSSSSSSSSWFFFFFHFFFFFFFFFFFFFFFFFWWSSSSSSSSSSSSSSSSSSSSSSSSSSSSSSSS
SWFFFFFFFFWSSSSSSSSSSSSSSSSSSSSSSSSSSSSSSSSSSSWFFFFFWWWWFFFFFFFFFFFFFFFWSSSSSSSSSSSSSSSSSSSSSSSSSSSSSSSS
SWFFFFFWWWWSSSSSSSSSSSSSSSSSSSSSSSSSSSSSSSSSSSWWWWWWWSSWWWWWFFFFFFFFFFWWSSSSSSSSSSSSSSSSSSSSSSSSSSSSSSSS
SWFFFWWWSSSSSSSSSSSSSSSSSSSSSSSSSSSSSSSSSSSSSSSSSSSSSSSSSSSWWFFFFFFFFFWSSSSSSSSSSSSSSSSSSSSSSSSSSSSSSSSS
SWFFFWSSSSSSSSSSSSSSSSSSSSSSSSSSSSSSSSSSSSSSSSSSSSSSSSSSSSSSWWFFFFFFFFWWSSSSSSSSSSSSSSSSSSSSSSSSSSSSSSSS
SWFFFWWSSSSSSSSSSSSSSSSSSSSSSSSSSSSSSSSSSSSSSSSSSSSSSSWWWWWWWWFFFFFFFFFWSSSSSSSSSSSSSSSSSSSSSSSSSSSSSSSS
SWFFFFWSSSSSSSWWWWWWWWWSSSSSSSSSSSSSSSSSSSSSSSSSSSSSWWWFFFFFFFFFFFFFFFFWSSSSSSSSSSSSSSSSSSSSSSSSSSSSSSSS
SWFFFFWSSSSSSSWFWWFFFFWWWWWWSSSSSSSSSSSSSSSSSSSWWWWWWFFFFFFFFFFFFFFFFFFWWSWWWSSSWWWWWWWWWWSSSSSSSSSSSSSS
SWFFFFWSSSSWWWWFHFFFFFFFFFFWWSSSSSSSSSSSSSSSSSSWFFFFFFFFFFFFFFFFFFFFFFFFWWWFWWWWWFFFFFFFFWWWWSSSSSSSSSSS
SWFFFFWWSWWWFWWFFFFFFFFFFFFFWWSSSSSSSSSSSSSSSSSWFFFFFFFFFFFFFFFFFFFFFFFFFFFFFFFFFFFFFFFFFFFFWWSSSSSSSSSS
SWFFFFFWWWFFFFFFFFFFFFFFFFFFFWSSSSSSSSSSSSSSSSSWFFFFFFFFFFFFFFFFFFFFFFFFFFFFFFFFFFFFFFFWWFFFFWWSSSSSSSSS
SWFFFFFFFFFFFFFFFFFFFFFFFFFFFWSSSSSSSSSSSSSSSSSWWFFFFWWFFFFFFFFFFFFFFFFFFFFFFFFFFFFFFFFWWFFFFFWWSSSSSSSS
SWFFFFFFFFFFFFFFFFFFFFFFFFFFFWSSSSSSSSSSSSSSSSSSWFFFFWWWFFFFFFFFFFFFFFFFFFFFFFFFFFFFFFFFFFFFFFFWWSSSSSSS
SWFFFFFFFFFFFFWWFFFFFFFFFFFFWWSSSSSSSSSSSSSSSSSSWFFFFWWWFFFFFFFFFFFFFFFFFFFFFFFFFFFFFFFFFFFFFFFFWSSSSSSS
SWFFFFFFFFFFFWWWWFFFFFFFFFWWWSSSSSSSSSSSSSSSSSSSWWFFFFFFFFFFFFFFFFWWWWWWWWWWWWWWFFFFFFFFFFFFFFFFWWSSSSSS
SWFFFFFFFFFFWWSSWWWWFFFFFFWSSSSSSSSSSSSSSSSSSSSSSWFFFFFFFFFFFFFFFWWSSSSSSSSSSSSWWFFFFFFWWWFFFFFFFWSSSSSS
SWFFFFFFFFWWWSSSSSSWFFFFFFWSSSSSSSSSSSSSSSSSSSSSSWFFFFFFFFFFFFFFWWSSSSSSSSSSSSSSWWFFFFFWWWFFFFFFWWSSSSSS
SWFFFFHWWWWSSSSSSSWWFFFFFFWSSSSSSSSSSSSSSSSSSSSSSWWFFFFFFFFFFFWWWSSSSSSSSSSSSSSSSWFFFFFFWWFFFFFFWSSSSSSS
SWFFFFFWSSSSSSSSSSWFFFFFFFWWSSSSSSSSSSSSSSSSSSSSSSWFFFFFFFFFFFWSSSSSSSSSSSSSSSSSWWFFFFFFFFFFFFFFWSSSSSSS
SWFFFFFWSSSSSSSSSSWFFFFFFFFWWSSSSSSSSSSSSSSSSSSSSSWWWFFFFFFFFFWWWSSSSSSSSSSSSSSWWFFFFFFFFFFFFFFWWSSSSSSS
SWFFFFFWSSSSSSSSSSWFFFFFFFFFWWWWWWWWWWWWWWWWWWWWWWWWWWWWFFFFFFFFWWSSSSSSSSSSSSWWFFFFFFFFFFFFFWWWSSSSSSSS
SWWFFFFWSSSSSSSSSSWFFFFFFFFFWWPPPWPPPPPPWPPPPPPPWPPPWWWWWWFFFFFFFWSSSSSSSSSSSWWFFFFFFFFFFFFFWWSSSSSSSSSS
SSWWFFFWSSSSSSSSSSWFFFFFFFFFWWPPPPPPPPPPPPPPPPPPPPPPWWWWWWFFFFFFFWWWWWWWWWWWWWFFFFFFFFFFFFWWWSSSSSSSSSSS
SSSWWFWWSSSSSSSSSSWFFFFFFFFFWWPPPPPPPPPPPPPPPPPPPPPPWFFFFWFFFFFFFFFFFFFFFFFFFFFFFFFFFFFFFWWSSSSSSSSSSSSS
SSSSWWWSSSSSSSSSSWWFFFFFFFFFFFFFFFFFFFFFFFFFFFFFFFFFWFFFFWFFFFFFFFFFFFFFFFFFFFFFFFFFFFFWWWSSSSSSSSSSSSSS
SSSSSSSSSSSSSSSSSWFFFFFFFFFFFFFFFFFFFFFFFFFFFFFFFFFFWFFFFWFFFFFFFFFFFFFFFFFFFFFFFFFFFWWWSSSSSSSSSSSSSSSS
SSSSSSSSSSSSSSSSSWFFFFFFFFFFFFFFFFFFFFFFFFFFFFFFFFFFDFFFFDFFFFFFFFFFFFFFFFFFFFFFFFWWWWSSSSSSSSSSSSSSSSSS
SSSSSSSSSSSSSSSSSWFFFFFFFFFFFFFFFFFFFFFFFFFFFFFFFFFFWFFFFWFFFFFFFFFFFFFFFFFFFFFFFWWSSSSSSSSSSSSSSSSSSSSS
SSSSSSSSSSSSSSSSSWWWFFFFFFFFWWPPPPPPPPPPPPPPPPPPPPPPWFFFFWWFFFFFFFFFFFFFFFFFFFWWWWSSSSSSSSSSSSSSSSSSSSSS
SSSSSSSSSSSSSSSSSSSWFFFFFFFFWWPPPPPPPPPPPPPPPPPPPPPPWFFFFWWWWWWFFFFFFFFFFFFFWWWSSSSSSSSSSSSSSSSSSSSSSSSS
SSSSSSSSSSSSSSSSSSSWWWWWFFFFWWPPPWPPPPPPWPPPPPPPWPPPWWWWWWSSSSWWWWWWWWWWWWWWWSSSSSSSSSSSSSSSSSSSSSSSSSSS
SSSSSSSSSSSSSSSSSSSSSSSWWWWWWWWWWWWWWWWWWWWWWWWWWWWWWSSSSSSSSSSSSSSSSSSSSSSSSSSSSSSSSSSSSSSSSSSSSSSSSSSS