FIRE
19.45047,3.384789
19,36;12,43;25,43;12,30;25,30;
SSSSSSSSSSSSSSWWWWWWWWWWWSSSSSSSSSSSSSS
SSSSSSSSSSSSSSWFFFFFFFFFWSSSSSSSSSSSSSS
SSSSSSSSSSSSSSWFFFFFFFFFWSSSSSSSSSSSSSS
SSSSSSSSSSSSSSWFFFFFFFFFWSSSSSSSSSSSSSS
SSSSSSSSSSSSSSWFFFFFFFFFWSSSSSSSSSSSSSS
SSSSSSSSSSSSSSWFFFFFFFFFWSSSSSSSSSSSSSS
SSSSSSSSSSSSSSWWWWWFWWWWWSSSSSSSSSSSSSS
SSSSSSSSSSSSSSSSSSWFWSSSSSSSSSSSSSSSSSS
SSSSSSSSSSSSSSSSSSWFWSSSSSSSSSSSSSSSSSS
SSSSSSSSSSSSSSSSSSWFWSSSSSSSSSSSSSSSSSS
SSSSSSSSSSSSSSSSSSWFWSSSSSSSSSSSSSSSSSS
SSSSSSSSSSSSSSSSSSWFWSSSSSSSSSSSSSSSSSS
SSSSSSSSSSSSSSSSSSWFWSSSSSSSSSSSSSSSSSS
SSSSSSSSSSSSSSSSSSWFWSSSSSSSSSSSSSSSSSS
SSSSSSSSSSSSSSSSSSWFWSSSSSSSSSSSSSSSSSS
SSSSSSSSSSSSSSSSSSWFWSSSSSSSSSSSSSSSSSS
SSSSSSSSSSSSSSSSSSWFWSSSSSSSSSSSSSSSSSS
SSSSSSSSSSSSSSWWWWWFWWWWWSSSSSSSSSSSSSS
SSSSSSSSSSSWWWWFFFFFFFFFWWWWSSSSSSSSSSS
SSSSSSSSSWWWFFFFFFFFFFFFFFFWWWSSSSSSSSS
SSSSSSSSWWFFFFFFFFFFFFFFFFFFFWWSSSSSSSS
SSSSSSWWWFFFFFFFFFFFFFFFFFFFFFWWWSSSSSS
SSSSSWWFFFFFFFFFFFFFFFFFFFFFFFFFWWSSSSS
SSSSWWFFFFFFFFFFFFFFFFFFFFFFFFFFFWWSSSS
SSSSWFFFFFFFFFFFFFFFFFFFFFFFFFFFFFWSSSS
SSSWWFFFFFFFFFFFFFFFFFFFFFFFFFFFFFWWSSS
SSWWFFFFFFFFFFFFFFFFFFFFFFFFFFFFFFFWWSS
SSWFFFFFFFFFFFFFFFFFFFFFFFFFFFFFFFFFWSS
SWWFFFFFFFFFFFFFFFFFFFFFFFFFFFFFFFFFWWS
SWFFFFFFFFFFWWFFFFFFFFFFFWWFFFFFFFFFFWS
SWFFFFFFFFFFWWFFFFFFFFFFFWWFFFFFFFFFFWS
WWFFFFFFFFFFFFFFFFFFFFFFFFFFFFFFFFFFFWW
WFFFFFFFFFFFFFFFFFFFFFFFFFFFFFFFFFFFFFW
WFFFFFFFFFFFFFFFFFFFFFFFFFFFFFFFFFFFFFW
WFFFFFFFFFFFFFFFFFFFFFFFFFFFFFFFFFFFFFW
WFFFFFFFFFFFFFFFFFFFFFFFFFFFFFFFFFFFFFW
WFFFFFFFFFFFFFFFFFFFFFFFFFFFFFFFFFFFFFW
WFFFFFFFFFFFFFFFFFFFFFFFFFFFFFFFFFFFFFW
WFFFFFFFFFFFFFFFFFFFFFFFFFFFFFFFFFFFFFW
WFFFFFFFFFFFFFFFFFFFFFFFFFFFFFFFFFFFFFW
WFFFFFFFFFFFFFFFFFFFFFFFFFFFFFFFFFFFFFW
WWFFFFFFFFFFFFFFFFFFFFFFFFFFFFFFFFFFFWW
SWFFFFFFFFFFWWFFFFFFFFFFFWWFFFFFFFFFFWS
SWFFFFFFFFFFWWFFFFFFFFFFFWWFFFFFFFFFFWS
SWWFFFFFFFFFFFFFFFFFFFFFFFFFFFFFFFFFWWS
SSWFFFFFFFFFFFFFFFFFFFFFFFFFFFFFFFFFWSS
SSWWFFFFFFFFFFFFFFFFFFFFFFFFFFFFFFFWWSS
SSSWWFFFFFFFFFFFFFFFFFFFFFFFFFFFFFWWSSS
SSSSWFFFFFFFFFFFFFFFFFFFFFFFFFFFFFWSSSS
SSSSWWFFFFFFFFFFFFFFFFFFFFFFFFFFFWWSSSS
SSSSSWWFFFFFFFFFFFFFFFFFFFFFFFFFWWSSSSS
SSSSSSWWWFFFFFFFFFFFFFFFFFFFFFWWWSSSSSS
SSSSSSSSWWFFFFFFFFFEFFFFFFFFFWWSSSSSSSS
SSSSSSSSSWWWFFFFFFFFFFFFFFFWWWSSSSSSSSS
SSSSSSSSSSSWWWWFFFFFFFFFWWWWSSSSSSSSSSS
SSSSSSSSSSSSSSWWWWWWWWWWWSSSSSSSSSSSSSS