DARK
4.919331,11.06495
0,15;9,0;0,32;21,15;1,23;3,27;14,27;26,24;37,11;34,17;42,20;61,6;50,15;54,13;66,14;85,0;74,7;93,14;112,0;101,7;117,14;136,0;126,7;127,7;119,12;6,59;37,33;33,49;20,39;31,37;33,48;26,51;16,54;7,75;39,64;19,70;31,72;44,77;92,47;56,74;67,63;81,67;85,61;68,57;65,62;54,64;49,58;44,43;66,23;55,32;70,36;82,26;76,33;76,29;87,37;107,17;98,19;96,21;98,33;95,27;108,57;133,31;109,45;132,45;121,45;3,14;1,20;4,14;2,20;20,17;27,17;20,18;27,18;20,19;27,19;5,31;10,37;6,31;11,37;7,31;12,37;8,31;13,37;36,14;43,14;36,15;43,15;36,16;43,16;36,17;43,17;60,10;67,6;60,11;67,7;65,30;71,30;65,31;71,31;65,32;71,32;46,42;47,48;47,42;48,48;48,42;49,48;49,42;50,48;50,42;51,48;38,69;46,70;38,70;46,71;38,71;46,72;38,72;46,73;81,33;88,33;81,32;88,32;81,31;88,31;81,30;88,30;12,63;14,59;47,23;50,20;108,26;112,24;57,17;119,11;83,67;82,5;83,5;84,5;109,5;110,5;111,5;107,11;107,12;107,13;131,11;131,12;131,13;109,7;110,7;111,7;102,13;102,12;102,11;96,7;95,7;94,7;102,3;102,2;102,1;
WWWWWWWSSSSSSSSSSSSSSSSSSSSSSSSSSSSSSSSSSSSSSSSSSSSSSSSSSSSSSSSSSSWWWWWWWWWWWWWWWWWWWWSSSSSSSWWWWWWWWWWWWWWWWWWWWSSSSWWWWWWWWWWWWWWWWWWWW
WFFFFFWSSSSSSSSSSSSSSSSSSSSSSSSSSSSSSSSSSSSSSSSSSSSSSSSSSSSSSSSSSSWFFFFFFFFFFFFFFFFFFWSSSSSSSWFFFFFFFFFFFFFFFFFFWSSSSWFFFFFFFFFFFFFFFFFFW
WFFFFFWSSSSSSSSSSSSSSSSSSSSSSSSSSSSSSSSSSSSSSSSSSSSSSSSSSSSSSSSSSSWFFFFFFFFFFFFFFFFFFWSSSSSSSWFFFFFFFFFFFFFFFFFFWSSSSWFFFFFFFFFFFFFFFFFFW
WFFFFFWSSSSSSSSSSSSSSSSSSSSSSSSSSSSSSSSSSSSSSSSSSSSSSSSSSSSSSSSSSSWFFFFFFFFFFFFFFFFFFWSSSSSSSWFFFFFFFFFFFFFFFFFFWSSSSWFFFFFFFFFFFFFFFFFFW
WFFFFFWSSSSSSSSSSSSSSSSSSSSSSSSSSSSSSSSSSSSSSSSSSSSSSSSSSSSSSSSSSSWFFFWWWWWWWWWWWWFFFWSSSSSSSWFFFWWWWWWWWWWWWFFFWSSSSWFFFWWWWWWWWWWWWFFFW
WFFFFFWSSSSSSSSSSSSSSSSSSSSSSSSSSSSSSSSSSSSSSSSSSSSSSSSSSSSSSSSSSSWFFFWHHHFHFPHFHWFFFWSSSSSSSWFFFWHHHFHFPHFHWFFFWSSSSWFFFWSSSSSSSSSSWFFFW
WFFFFFWSSSSSSSSSSSSSSSSSSSSSSSSSSSSSSSSSSSSSSSSSSSSSSSSWWWWWWSSSSSWFFFWFPHHHPHHPPWFFFWSSSSSSSWFFFWFPHHHPHHPPWFFFWSSSSWFFFWSSSSSSSSSSWFFFW
WFFFFFWWSSSSSSSSSSSSSSSSSSSSSSSSSSSSSSSSSSSSSSSSSSSSSWWWHFFFWSSSSSWFFFWHHHFPPHFHPWFFFWSSSSSSSWFFFWHHHFPPHFHPWFFFWSSSSWFFFWSSSSFFSSSSWFFFW
WFFFFFFWWWSSSSSSSSSSSSSSSSSSSSSSSSSSSSSSSSSSSSSSSSSSWWHFFFFFWWSSSSWFHHWHHHFHHHHHHWFFFWSSSSSSSWFFFWHHHFHHHHHHWFFFWSSSSWFFFWSSSSSSSSSSWFFFW
WFFFFFFFFWSSSSSSSSSSSSSSSSSSSSSSSSSSSSSSSSSSSSSSSSWWWHHFFFFFFWSSSSWHHFWHHHHFPPFHFWFFFWSSSSSSSWFFFWHHHHFPPFHFWFFFWSSSSWFHHWSSSSSSSSSSWFFFW
WFFFFFFFFWSSSSSSSSSSSSSSSSSSSSSSSSSSSSSSSSSSSSSSWWWHHFFFFFFFFWSSSSWFFFWWWWWWWWWWWWFFFWSSSSSSSWFFFWWWWWWWWWWWWFFFWSSSSWHHFWWWWWWWWWWWWFFFW
WWWFFFFFWWSSSSSSSSSSSSSSSSSWWWWWWWWWWWSSSSSSSSSWWFFFFFFFFFFFFWSSSSWFFFFFFFFFFFFFFFFFFWSSSSSSSWFFFFFFFFFFFFFFFFFFWSSSSWFFFFFFFFFFFFFFFFFFW
SSWFFFFWWSSSSSSSSSSSSSSSSSSWFFFFFFFFFWSSSSWWWWWWHHFFFFFFFFFFFWSSSSWFFFFFFFFFFFFFFFFFFWSSSSSSSWFFFFFFFFFFFFFFFFFFWSSSSWFFFFFFFFFFFFFFFFFFW
SWWFFFFWSSSSSSSSSSSSSSSSSSWWFFFFFFFFFWSSSSWFHFFFFFFFFFFFFFFFFWSSSSWFFFFFFFFFFFFFFFFFFWSSSSSSSWFFFFFFFFFFFFFFFFFFWSSSSWFFFFFFFFFFFFFFFFFFW
SWFFFFWWSSSSSSSSSSSSSSSSSSWFFFFFFFFFFWSSSSWFFFFFFFFFFFFFFFFFHWSSSSWWWWWWWWWWWWWWWWWWWWSSSSSSSWWWWWWWWWWWWWWWWWWWWSSSSWWWWWWWWWWWWWWWWWWWW
SWWWWWWSSSWWWWWWWSSSSSSSSSWFFFFFFFFFFWSSSSWFFFFFFFFFFFFFFFHFPWSSSSSSSSSSSSSSSSSSSSSSSSSSSSSSSSSSSSSSSSSSSSSSSSSSSSSSSSSSSSSSSSSSSSSSSSSSS
SSSSSSSSSSWFFFFFWWWWWWSSSSWFFFFFFFFFFWSSSSWFFFFFFFFFFFFHHFHPPWSSSSSSSSSSSSSSSSSSSSSSSSSSSSSSSSSSSSSSSSSSSSSSSSSSSSSSSSSSSSSSSSSSSSSSSSSSS
SSSSSSSSSSWFFFFFFFFFFWSSSSWFFFFFFFFFFWSSSSWFFFFFFFFFFHHPPFFPFWSSSSSSSSSSSSSSSSSSSSSSSSSSSSSSSSSSWWWWSSSSSSSSSSSSSSSSSSSSSSSSSSSSSSSSSSSSS
SSSSSSSSWWWFFWWFFFFFFWSSSSWFFFFFFFFFFWSSSSWWHFFFFFFHFFPPPWWWWWSSSSSSSSSSSSSSSSSSSSSSSSSSSSSSSSWWWFFWWSSSSSSSSSSSSSSSSSSSSSSSSSSSSSSSSSSSS
WWWWSWWWWFFFFWWFFFFFFWSSSSWFFFFFFFFFFWSSSSSWWWPFFFFHHPPWWWSSSSSSSSSSSSSSSSSSSSSSSSSSSSSSSSSSSWWFFFFFWSSSSSSSSSSSSSSSSSSSSSSSSSSSSSSSSSSSS
WFFWWWFFFFFFFWWWFFWWWWSSSSWFFFFFFFFFWWSSSSSSSWWWWWWWWWWWSSSSSSSSSSSSSSSSSSSSSSSSSSSSSSSSSSSSWWFFFFFFWWSSSSSSSSSSSSSSSSSSSSSSSSSSSSSSSSSSS
WFFFFFFFFFFFFWWWWWWSSSSSSSWFFFFFFFFFWSSSSSSSSSSSSSSSSSSSSSSSSSSSSSSSSSSSSSSSSSSSSSSSSSSSSSSWWFFFFFFFFWSSSSSSSSSSSSSSSSSSSSSSSSSSSSSSSSSSS
WFFFFFFFFFFFFFFWWSSSSSSSSSWWFFFFFFFWWSSSSSSSSSSSSSSSSSSSSSSSSSSSSSSSSSSSSSSSSSSSSSSSSSSSSSSWFFFFFFFFWWSSSSSSSSSSSSSSSSSSSSSSSSSSSSSSSSSSS
WFFFFFFFFFFFFFFFWSSSSSSSSSSWWWFFFFFWSSSSSSSSSWWWWWWWSSSSSSSSSSSSSSSSSSSSSSSSSSSSSSSSSSSSSSSWFFFFFFFWWSWWWWWWWSSSWWWWWWWWWWWWSSSSSSSSSSSSS
WFFFFFFFFFFFFFFFWSSSSSSSSSSSSWWWWWWWSSSSSSSSSWFFFFFWSSSSSSSSSSSSSSSSSSSSSSSSSSSSSSSSSSSSSSWWFFFFFFWWWWWFFFFFWSSSWFFFFFFFFFFWSSSSSSSSSSSSS
WFFFFFFWWWWFFFFFWSSSSSSSSSSSSSSSSSSSSSSSSSSSSWFFFFFWWSSSSSSSSSSSSSSSSSSSSSSSSSSSSSSSSSSSSSWFFFFFFFWWFFFFFFFFWSSSWFFFFFFFFFFWSSSSSSSSSSSSS
WWFFFFFWSSWWFFFFWSSSSSSSSSSSSSSSSSSSSSSSSSSSSWFFFFFFWWSSSSSSSSSSSSSSSSSSSSWWWWWWWWWSSSSSSSWFFFFFFFFFFFFFFFFFWSSSWFFFFFFFFFFWSSSSSSSSSSSSS
SWFFFFFWSSSWFFFFWSSSSSSSSSSSSSSSSSSSSSSSSSSSSWHHFFFFFWWWSSSSSSSSSSSSSSSSWWWFFFFFFFWSSSSSSSWFFFFFFFFFFFFFFFWWWSSSWWWWWWWWFFFWSSSSSSSSSSSSS
SWFFFFFWWSWWFFFFWSSSSSSSSSSSSSSSSSSSSSSSSSSSSWWHHFFFFFFWWWWWSSSSSSSSSSWWWFFFFFFFFFWSSSSSSWWFFFFFFFFFFFFWWWWSSSSSSSSSSSSWFFFWSSSSSSSSSSSSS
WWFFFFFFWWWFFFFFWSSSSSSSSSSSSSSSSSSSSSSSSSSSSSWWHPFFFFFFHHPWWWWWWWWSSSWFFFFFFFFFFFWSSSSWWWFFFFFFFFFFWWWWSSSSSSSSSSSSSSSWFFFWSSSSSSSSSSSSS
WFFFFFFFFFFFFFFFWSSSSSSSSSSSSSSSSSSSSSSSSSSSSSSWWPPFFFFFFHHHHHFFFFWSSSWFFFFFFFFFFFWSSSSWFFFFFFFFFWWWWWWWWSSSSSSSSSSSSSSWFFFWSSSSSSSSSSSSS
WWFFFFFFFFFFFFFWWSSSSSSSSSSSSSSSSSSSSSSSSSSSSSSSWWWFFFFFFFFFFFFFFFWSSSWFFFFFFFFFFFWSSSSWFFFFFFFFFWWFFFFFWSSSSSSSSSWWWWWWFFFWWWSSSSSSSSSSS
SWWWWWWWWWWWWWWWSSSSSSSSSSSSSSSSSSSSSSSSSSSSSSSSSSWWFFFFFFFFFFFFFFWSSSWFFFFFFFFFFFWSSSSWFFFFFFFFFFFFFFFFWSSSSSSSSWWPPPPPFFFPPWWWSSSSSSSSS
SSSSSSSSSSSSSSSSSSSSSSSSSSSSWWWWWWWSSSSSSSSSSSSSSSSWHFFFFFFPWWWWWWWSSSWFFFFFFFFFFFWSSSSWFFFFFFFFFFFFFFFWWSSSSSSSWWPPPPPPFFFPPPPWWWSSSSSSS
SSSSSSSSSSSSSSSSSSSWWWWWWWWWWFFFFFWWSSSSSSSSSSSSSSWWFFFFFPPWWSSSSSSSSSWWFFFFFFFFFWWSSSSWWFFFFFFFFFFFFFWWSSSSSSSWWPPPPPPPFFFPPPPPPWWSSSSSS
SSSSSSSSSSSSSSSSSSSWFFFFFFFFFFFFFFFWWSSSSSSSSSSSSWWFFFFFFPWWSSSSSSSSSSSWFFFFFFFFWWSSSSSSWWWFFFFFFFFFWWWSSSSSSSSWPPPPPPFFFFFFPPPPPPWWSSSSS
SSSSSSSSSWWWWWWSSWWWFFFFFFFFFFFFFFFFWSSSSSSSSSSSSWPFFFFFFWWSSSSSSSSSSSSWWWWWWWWWWSSSSSSSSSWWFFFFFWWWWSSSSSSSSSWWPPPPFFFFFFFFFPPPPPPWSSSSS
SSSSSSSSWWFFFFWWWWFFFFFFFFFFFFFFFFFFWSSSSSSSSSSWWWFFFFFFWWSSSSSSSSSSSSSSSSSSSSSSSSSSSSSSSSSWWWWWWWSSSSSSSSSSSSWPPPPFFFFFFFFFFFFPPPPWWSSSS
SSSSSSSSWFFFFFFFFFFFFFFFFFFFFFFFFFFFWSSSSSSSSSWWPFFFFFFWWSSSSSSSSSSSSSSSSSSSSSSSSSSSSSSSSSSSSSSSSSSSSSSSSSSSSWWPPPFFFFFFFFFFFFFFPPPPWSSSS
SSSSSSSWWFFFFFFFFFFFFFFFFFFFFFFFFFFFWSSSSSSSSWWPFFFFFHHWSSSSSSSSSSSSSSSSSSSSSSSSSSSSSSSSSSSSSSSSSSSSSSSSSSSSWWPPPFFFFFFFFFFFFFFFFPPPWWSSS
SSSSSSSWFFFFFFFFFFFFFFFFFFFFFFFFFFFFWSSSSSSSWWFFFFFHHHWWSSSSSSSSSSSSSSSSSSSSSSSSSSSSSSSSSSSSSSSSSSSSSSSSSSSSWPPPFFFFFFFFFFFFFFFFFFPPPWSSS
SSSSSSWWFFFFFFFFFFFFFFFFFFFWWWWWWWFFWSSSSSSSWFFFFFFHHWWSSSSSSSSSSSSSSSSSSSSSSSSSSSSSSSSSSSSSSSSSSSSSSSSSSSSSWPPPFFFFFFFFFFFFFFFFFFPPPWSSS
SSSSSSWFFFFFFFFFFFFFFFFFWWWWSSSSWWFFWSSSSSSSWFFFFFFWWWSSSSSSSSSSSSSSSSSSSSSSSSSSSSSSSSSSSSSSSSSSSSSSSSSSSSSSWPPFFFFFFFFFFFFFFFFFFFFPPWSSS
SSSSSSWFFFFFFFFFFFFFFWWWWSSSSSSSWFFFWSSSSSSSWWWWWWWWSSSSSSSSSSSSSSSSSSSSSSSSSSSSSSSSSSSSSSSSSSSSSSSSSSSSSSSSWPPFFFFFFFFFFFFFFFFFFFFPPWSSS
SSSSSSWFFFFFFFFFFFFFWWSSSSSSSSSWWFFFWSSSSSSSSSSSSSSSSSSSSSSSSSSSSSSSSSSSSSSSSSSSSSSSSSSSSSSSSSSSSSSSSSSSSSSSWPPFFFFFFFFFFFFFFFFFFFFPPWSSS
SSSSSSWWWFFFFFFFFFWWWSSSSSSSSWWWFFFFWWSSSSSSSSSSSSSSSSSSSSSSSSSSSSSSSSSSSSSSSSSSSSSSSSSSSSSSSSSSSSSSSSSSSSSSWFPFFFFFFFFFFFFFFFFFFFFPFWSSS
SSSSSSSSWWFFFFFFFFWSSSSSSSSWWWFFFFFFFWSSSSSSSSSSSSSSSSSSSSSSSSSSSSSSSSSSSSSSSSSSSSSSSSSSSSSSSSSSSSSSSSSSSSSSWPPFFFFFFFFFFFFFFFFFFFFPPWSSS
SSSSSSSSSWFFFFFFFFWWSSSSSWWWFFFFFFFFFWSSSSSSSSWWWWWWWSSSSSSSSSSSSSSSSSSSSSSSSSSSSSSSSSSSSSSSSSSSSSSSSSSSSSSSWPPFFFFFFFFFFFFFFFFFFFFPPWSSS
SSSSSSSSSWFFFFFFFFFWWWWWWWFFFFFFFFFFFWSSSSSSSWWFFFFFWWWSSSSSSSSSSSSSSSSSSSSSSSSSSSSSSSSSSSSSSSSSSSSSSSSSSSSSWPPPFFFFFFFFFFFFFFFFFFFPPWSSS
SSSSSSSSSWWFFFFFFFFFFFFFFFFFFFFFFFFFFWSSSSSSSWFFFFFFFFWWSSSSSSSSSSSSSSSSSSSSSSSSSSSSSSSSSSSSSSSSSSSSSSSSSSSSWPPPFFFFFFFFFFFFFFFFFFPPPWSSS
SSSSSSSSSSWWWFFFFFFFFFFFFFFFFFFFFFFFFWSSSSSSWWFFFFFFFFFWSSSSSSSSSSSSSSSSSSSSSSSSSSSSSSSSSSSSSSSSSSSSSSSSSSSSWWPPFFFFFFFFFFFFFFFFFFPPPWSSS
SSSSSSSSSSSSWWWFFFFFFFFFFFFFFFFFFFFFFWSSSSSSWFFFFFFFFFFWWWSSSSSSSSSSSSSSSSSSSSSSSSSSSSSSSSSSSSSSSSSSSSSSSSSSSWPPPFFFFFFFFEFFFFFFFPPPWWSSS
SSSSSSSSSSWWWWWFFFFFFFFFFFFFFFFFFFFFWWSSSSSWWFFFFFFFFFFFFWWWWWWSSSSSSSSSSSSSSSSSSSSSSSSSSSSSSSSSSSSSSSSSSSSSSWPPPPPFFFFFFFFFFFFFFPPPWSSSS
SSSSSSSSSSWFFFFFFFFFFFFFFFFFFFFWWWWWWSSSSSSWFFFFFFFFFFFFFFFFFFWWWWWWSSSSSSSSSSSSSSSSSSSSSSSSSSSSSSSSSSSSSSSSSWWPPPPPFFFFFFFFFFFPPPPWWSSSS
SSSSSSSSSSWFFFFFFFFFFFFFFFFWWWWWSSSSSSSSSSSWFFFFFFFFFFFFFFFFFFFFFFFWWWWWWWSSSSSSSSSSSSSSSSSSSSSSSSSSSSSSSSSSSSWWWPPPPPPPPPPPPPPPPPWWSSSSS
SSSSSSSSSWWFFFFFFFFFFFWWWWWWSSSSSSSSSSSSSSSWFFFFFFFFFFFFFFFFFFFFFFFFFFFFFWWWWSSSSSSSSSSSSSSSSSSSSSSSSSSSSSSSSSSSWWWPPPPPPPPPPPPPWWWSSSSSS
SSSSSSSSSWFFFFFFFFFWWWWSSSSSSSSSSSSSSSSSSSSWFFFFFFFFFFFFFFFFFFFFFFFFFFFFFFFFWWWWSSSSSSSSSSSSSSSSSSSSSSSSSSSSSSSSSSWWWWWPPPPPWWWWWSSSSSSSS
SSSSSSSSSWFFFFFFFWWWSSSSSSSSSSSSSSSSSSSSSSSWWFFFFFFFFFWWWWFFFFFFFFFFFFFFFFFFFFFWWWSSSSSSSSSSSSSSSSSSSSSSSSSSSSSSSSSSSSWWWWWWWSSSSSSSSSSSS
SSSSSSSSSWWFFFFFWWSSSSSSSSSSSSSSSSSSSSSSSSSSWWFFFFFFFFWSSWWFFFFFFFFFFFFFFFFFFFFFFWWWWWWWWWWWWSSSSSSSSSSSSSSSSSSSSSSSSSSSSSSSSSSSSSSSSSSSS
SSSSSSSSSSWWWWWWWSSSSSSSSSSSSSSSSSSSSSSSSSSSSWWFFFFFFFWSSWWFFFFFFFFFFFFFFFFFFFFFFFFFFFFFFFFFWSSSSSSSSSSSSSSSSSSSSSSSSSSSSSSSSSSSSSSSSSSSS
SSSSSSSSSSSSSSSSSSSSSSSSSSSSSSSSSSSSSSSSSSSSSSWWFFFFFFWWWWFFFFFFFFFFFFFFFFFFWWFFFFFFFFFFFFFFWSSSSSSSSSSSSSSSSSSSSSSSSSSSSSSSSSSSSSSSSSSSS
SSSSSSSSSSSSSSSSSSSSSSSSSSSSSSSSSSSSSSSSSSSSSSSWFFFFFFFFFFFFFFFFFFFFFFFFFFFFWWWFFFFFFFFFFFFWWSSSSSSSSSSSSSSSSSSSSSSSSSSSSSSSSSSSSSSSSSSSS
SSSSSSSSSSSSSSSSSSSSSSSSSSSSSSSSSSSSSSSSSSSSSSSWWFFFFFFFFFFFFFFFFFFFFFFFFFFFFWWWWFFFFFFFFFWWSSSSSSSSSSSSSSSSSSSSSSSSSSSSSSSSSSSSSSSSSSSSS
SSSSSSSSSSWWWWWWSSSSSSSSSSSSSSSSSSSSSSSSSSSSSSSSWWFFFFFFFFFFFFFFFFFFFFFFFFFFFFWWWFFFFFFFFWWSSSSSSSSSSSSSSSSSSSSSSSSSSSSSSSSSSSSSSSSSSSSSS
SSSSSSSWWWWFFFFWSSSSSSSSSSSSSSSSSSSSSSSSSSSSSSSSSWFFFFFFFFFFFFFFFFFFFFFFFFFFFFFFFFFFFFFFFWSSSSSSSSSSSSSSSSSSSSSSSSSSSSSSSSSSSSSSSSSSSSSSS
SSSSSSSWFFFFFFFWSSSSSSSSSSSSSSSSSSSSSSSSSSSSSSSSSWFFFFFFFFFFFFFFWWWWWWWWWWWWFFFFFFFFFFFFFWSSSSSSSSSSSSSSSSSSSSSSSSSSSSSSSSSSSSSSSSSSSSSSS
SSSSSSSWFFFFFWWWWWWWWSSSSSSSSSSSSSSSSSSSSSSSSSSSSWFFFFFFFFFFWWWWWSSSSSSSSSSWWFFFFFFFFFFFWWSSSSSSSSSSSSSSSSSSSSSSSSSSSSSSSSSSSSSSSSSSSSSSS
SSSSSSSWFFFFFWWWFFFFWWSSWWWWWWSSSSSSSWWWSSSSSSSSWWFFFFFFFFFWWSSSSSSSSSSSSSSSWWFFFFFFFFFWWSSSSSSSSSSSSSSSSSSSSSSSSSSSSSSSSSSSSSSSSSSSSSSSS
SSSSSSSWFFFFFFFFFFFFFWWWWFFFFWWWWWSWWWFWSSSSSSWWWFFFFFFFFFFWSSSSSSSSSSSSSSSSSWFFFFFFFWWWSSSSSSSSSSSSSSSSSSSSSSSSSSSSSSSSSSSSSSSSSSSSSSSSS
SSSSSSSWWFFFFFFFFFFFFFFFFFFFFFFFFWWWFFFWSSSSSWWFFFFFFFFFFFFWSSSSSSSSSSSSSSSSSWFFFFFFFWSSSSSSSSSSSSSSSSSSSSSSSSSSSSSSSSSSSSSSSSSSSSSSSSSSS
SSSSSSSSWWWFFFFFFFFFFFFFFFFFFFFFFFFFFFFWSSSSWWFFFFFFFFFFFFWWWWSSSSSSSSSSSSSSSWFFFFFWWWSSSSSSSSSSSSSSSSSSSSSSSSSSSSSSSSSSSSSSSSSSSSSSSSSSS
SSSSSSSSSSWWFFFFFFFFFFFFFFFFFFFFFFFFFFFWSSSSWFFFFFFFFFFFFWWFFWWSSSSSSSSSSSSSSWWWWWWWSSSSSSSSSSSSSSSSSSSSSSSSSSSSSSSSSSSSSSSSSSSSSSSSSSSSS
SSSSSSSSSSSWWWFFFFFFFFFFFFFFFFFFFFFFFFFWSSSSWWFFFFFFFFFFFWWFFFWWWSSSSSSSSSSSSSSSSSSSSSSSSSSSSSSSSSSSSSSSSSSSSSSSSSSSSSSSSSSSSSSSSSSSSSSSS
SSSSSSSSSSSSSWFFFFFFFFFFFFFFFFFFFFFFFFFWSSSSSWFFFFFFFFFFFWWFFFFFWSSSSSSSSSSSSSSSSSSSSSSSSSSSSSSSSSSSSSSSSSSSSSSSSSSSSSSSSSSSSSSSSSSSSSSSS
SSSSSSSSSSSSSWFFFFFWWWWWWWWFFFFFFFFFFFWWSSSSSWWFFFFFFFFFFFFFFFFFWSSSSSSSSSSSSSSSSSSSSSSSSSSSSSSSSSSSSSSSSSSSSSSSSSSSSSSSSSSSSSSSSSSSSSSSS
SSSSSSSSSSSSSWWWWWWWSSSSSSWWWWFFFFFFFFWSSSSSSSWWFFFFFFFFFFFFFFFFWSSSSSSSSSSSSSSSSSSSSSSSSSSSSSSSSSSSSSSSSSSSSSSSSSSSSSSSSSSSSSSSSSSSSSSSS
SSSSSSSSSSSSSSSSSSSSSSSSSSSSSWWWWFFFFFWSSSSSSSSWWFFFFFFFFFFFWWWWWSSSSSSSSSSSSSSSSSSSSSSSSSSSSSSSSSSSSSSSSSSSSSSSSSSSSSSSSSSSSSSSSSSSSSSSS
SSSSSSSSSSSSSSSSSSSSSSSSSSSSSSSSWWWWWWWSSSSSSSSSWWWWWWWWWWWWWSSSSSSSSSSSSSSSSSSSSSSSSSSSSSSSSSSSSSSSSSSSSSSSSSSSSSSSSSSSSSSSSSSSSSSSSSSSS