DEFAULT
4.919331,11.06495
0,15;9,0;0,32;21,15;1,23;3,27;14,27;26,24;37,11;34,17;42,20;61,6;50,15;54,13;66,14;85,0;74,7;93,14;112,0;101,7;117,14;136,0;126,7;127,7;119,12;
WWWWWWWSSSSSSSSSSSSSSSSSSSSSSSSSSSSSSSSSSSSSSSSSSSSSSSSSSSSSSSSSSSWWWWWWWWWWWWWWWWWWWWSSSSSSSWWWWWWWWWWWWWWWWWWWWSSSSWWWWWWWWWWWWWWWWWWWW
WFFFFFWSSSSSSSSSSSSSSSSSSSSSSSSSSSSSSSSSSSSSSSSSSSSSSSSSSSSSSSSSSSWFFFFFFFFFFFFFFFFFFWSSSSSSSWFFFFFFFFFFFFFFFFFFWSSSSWFFFFFFFFFFFFFFFFFFW
WFFFFFWSSSSSSSSSSSSSSSSSSSSSSSSSSSSSSSSSSSSSSSSSSSSSSSSSSSSSSSSSSSWFFFFFFFFFFFFFFFFFFWSSSSSSSWFFFFFFFFFFFFFFFFFFWSSSSWFFFFFFFFFFFFFFFFFFW
WFFFFFWSSSSSSSSSSSSSSSSSSSSSSSSSSSSSSSSSSSSSSSSSSSSSSSSSSSSSSSSSSSWFFFFFFFFFFFFFFFFFFWSSSSSSSWFFFFFFFFFFFFFFFFFFWSSSSWFFFFFFFFFFFFFFFFFFW
WFFFFFWSSSSSSSSSSSSSSSSSSSSSSSSSSSSSSSSSSSSSSSSSSSSSSSSSSSSSSSSSSSWFFFWWWWWWWWWWWWFFFWSSSSSSSWFFFWWWWWWWWWWWWFFFWSSSSWFFFWWWWWWWWWWWWFFFW
WFFFFFWSSSSSSSSSSSSSSSSSSSSSSSSSSSSSSSSSSSSSSSSSSSSSSSSSSSSSSSSSSSWFFFWHHHFHFPHFHWFFFWSSSSSSSWFFFWHHHFHFPHFHWFFFWSSSSWFFFWSSSSSSSSSSWFFFW
WFFFFFWSSSSSSSSSSSSSSSSSSSSSSSSSSSSSSSSSSSSSSSSSSSSSSSSWWWWWWSSSSSWFFFWFPHHHPHHPPWFFFWSSSSSSSWFFFWFPHHHPHHPPWFFFWSSSSWFFFWSSSSSSSSSSWFFFW
WFFFFFWWSSSSSSSSSSSSSSSSSSSSSSSSSSSSSSSSSSSSSSSSSSSSSWWWHFFFWSSSSSWFFFWHHHFPPHFHPWFFFWSSSSSSSWFFFWHHHFPPHFHPWFFFWSSSSWFFFWSSSSFFSSSSWFFFW
WFFFFFFWWWSSSSSSSSSSSSSSSSSSSSSSSSSSSSSSSSSSSSSSSSSSWWHFFFFFWWSSSSWFHHWHHHFHHHHHHWFFFWSSSSSSSWFFFWHHHFHHHHHHWFFFWSSSSWFFFWSSSSSSSSSSWFFFW
WFFFFFFFFWSSSSSSSSSSSSSSSSSSSSSSSSSSSSSSSSSSSSSSSSWWWHHFFFFFPWSSSSWHHFWHHHHFPPFHFWFFFWSSSSSSSWFFFWHHHHFPPFHFWFFFWSSSSWFFFWSSSSSSSSSSWFFFW
WFFFFFFFFWSSSSSSSSSSSSSSSSSSSSSSSSSSSSSSSSSSSSSSWWWHHFFFFFFFFWSSSSWFFFWWWWWWWWWWWWFFFWSSSSSSSWFFFWWWWWWWWWWWWFFFWSSSSWFFFWWWWWWWWWWWWFFFW
WWWFFFFFWWSSSSSSSSSSSSSSSSSWWWWWWWWWWWSSSSSSSSSWWFFFFFFFFFFFFWSSSSWFFFFFFFFFFFFFFFFFFWSSSSSSSWFFFFFFFFFFFFFFFFFFWSSSSWFFFFFFFFFFFFFFFFFFW
SSWFFFFWWSSSSSSSSSSSSSSSSSSWFFFFFFFFFWSSSSWWWWWWHHFFFFFFFFFFFWSSSSWFFFFFFFFFFFFFFFFFFWSSSSSSSWFFFFFFFFFFFFFFFFFFWSSSSWFFFFFFFFFFFFFFFFFFW
SWWFFFFWSSSSSSSSSSSSSSSSSSWWFFFFFFFFFWSSSSWFHFFFFFFFFFFFFFFFFWSSSSWFFFFFFFFFFFFFFFFFFWSSSSSSSWFFFFFFFFFFFFFFFFFFWSSSSWFFFFFFFFFFFFFFFFFFW
SWFFFFWWSSSSSSSSSSSSSSSSSSWFFFFFFFFFFWSSSSWFFFFFFFFFFFFFFFFFHWSSSSWWWWWWWWWWWWWWWWWWWWSSSSSSSWWWWWWWWWWWWWWWWWWWWSSSSWWWWWWWWWWWWWWWWWWWW
SWWWWWWSSSWWWWWWWSSSSSSSSSWFFFFFFFFFFWSSSSWFFFFFFFFFFFFFFFHFPWSSSSSSSSSSSSSSSSSSSSSSSSSSSSSSSSSSSSSSSSSSSSSSSSSSSSSSSSSSSSSSSSSSSSSSSSSSS
SSSSSSSSSSWFFFFFWWWWWWSSSSWFFFFFFFFFFWSSSSWFFFFFFFFFFFFHHFHPPWSSSSSSSSSSSSSSSSSSSSSSSSSSSSSSSSSSSSSSSSSSSSSSSSSSSSSSSSSSSSSSSSSSSSSSSSSSS
SSSSSSSSSSWFFFFFFFFFFWSSSSWFFFFFFFFFFWSSSSWFFFFFFFFFFHHPPFFPFWSSSSSSSSSSSSSSSSSSSSSSSSSSSSSSSSSSWWWWSSSSSSSSSSSSSSSSSSSSSSSSSSSSSSSSSSSSS
SSSSSSSSWWWFFWWFFFFFFWSSSSWFFFFFFFFFFWSSSSWWHFFFFFFHFFPPPWWWWWSSSSSSSSSSSSSSSSSSSSSSSSSSSSSSSSWWWFFWWSSSSSSSSSSSSSSSSSSSSSSSSSSSSSSSSSSSS
WWWWSWWWWFFFFWWFFFFFFWSSSSWFFFFFFFFFFWSSSSSWWWPFFFFHHPPWWWSSSSSSSSSSSSSSSSSSSSSSSSSSSSSSSSSSSWWFFFFFWSSSSSSSSSSSSSSSSSSSSSSSSSSSSSSSSSSSS
WFFWWWFFFFFFFWWWFFWWWWSSSSWFFFFFFFFFWWSSSSSSSWWWWWWWWWWWSSSSSSSSSSSSSSSSSSSSSSSSSSSSSSSSSSSSWWFFFFFFWWSSSSSSSSSSSSSSSSSSSSSSSSSSSSSSSSSSS
WFFFFFFFFFFFFWWWWWWSSSSSSSWFFFFFFFFFWSSSSSSSSSWFFFFWSSSSSSSSSSSSSSSSSSSSSSSSSSSSSSSSSSSSSSSWWFFFFFFFFWSSSSSSSSSSSSSSSSSSSSSSSSSSSSSSSSSSS
WFFFFFFFFFFFFFFWWSSSSSSSSSWWFFFFFFFWWSSSSSSSSSWFFFFWSSSSSSSSSSSSSSSSSSSSSSSSSSSSSSSSSSSSSSSWFFFFFFFFWWSSSSSSSSSSSSSSSSSSSSSSSSSSSSSSSSSSS
WFFFFFFFFFFFFFFFWSSSSSSSSSSWWWFFFFFWSSSSSSSSSWWWWWWWSSSSSSSSSSSSSSSSSSSSSSSSSSSSSSSSSSSSSSSWFFFFFFFWWSWWWWWWWWWWWWWWWWWWWWWWSSSSSSSSSSSSS
WFFFFFFFFFFFFFFFWSSSSSSSSSSSSWWWWWWWSSSSSSSSSWFFFFFWSSSSSSSSSSSSSSSSSSSSSSSSSSSSSSSSSSSSSSWWFFFFFFWWWWWFFFFFWFFFWFFFFFFFFFFWSSSSSSSSSSSSS
WFFFFFFWWWWFFFFFWSSSSSSSSSSSSSSSSSSSSSSSSSSSSWFFFFFWWSSSSSSSSSSSSSSSSSSSSSSSSSSSSSSSSSSSSSWFFFFFFFWWFFFFFFFFWFFFWFFFFFFFFFFWSSSSSSSSSSSSS
WWFFFFFWSSWWFFFFWSSSSSSSSSSSSSSSSSSSSSSSSSSSSWFFFFFFWWSSSSSSSSSSSSSSSSSSSSWWWWWWWWWSSSSSSSWFFFFFFFFFFFFFFFFFWFFFWFFFFFFFFFFWSSSSSSSSSSSSS
SWFFFFFWSSSWFFFFWSSSSSSSSSSSSSSSSSSSSSSSSSSSSWHHFFFFFWWWSSSSSSSSSSSSSSSSWWWFFFFFFFWSSSSSSSWFFFFFFFFFFFFFFFWWWWWWWWWWWWWWFFFWSSSSSSSSSSSSS
SWFFFFFWWSWWFFFFWSSSSSSSSSSSSSSSSSSSSSSSSSSSSWWHHFFFFFFWWWWWSSSSSSSSSSWWWFFFFFFFFFWSSSSSSWWFFFFFFFFFFFFWWWWSSSSSSSSSSSSWFFFWSSSSSSSSSSSSS
WWFFFFFFWWWFFFFFWSSSSSSSSSSSSSSSSSSSSSSSSSSSSSWWHPFFFFFFHHPWWWWWWWWSSSWFFFFFFFFFFFWSSSSWWWFFFFFFFFFFWWWWSSSSSSSSSSSSSSSWFFFWSSSSSSSSSSSSS
WFFFFFFFFFFFFFFFWSSSSSSSSSSSSSSSSSSSSSSSSSSSSSSWWPPFFFFFFHHHHHFFFFWSSSWFFFFFFFFFFFWSSSSWFFFFFFFFFWWWWWWWWSSSSSSSSSSSSSSWFFFWSSSSSSSSSSSSS
WWFFFFFFFFFFFFFWWSSSSSSSSSSSSSSSSSSSSSSSSSSSSSSSWWWFFFFFFFFFFFFFFFWSSSWFFFFFFFFFFFWSSSSWFFFFFFFFFWWFFFFFWSSSSSSSSSWWWWWWFFFWWWSSSSSSSSSSS
SWWWWWWWWWWWWWWWSSSSSSSSSSSSSSSSSSSSSSSSSSSSSSSSSSWWFFFFFFFFFFFFFFWSSSWFFFFFFFFFFFWSSSSWFFFFFFFFFFFFFFFFWSSSSSSSSWWPPPPPFFFPPWWWSSSSSSSSS
SSSSSSSSSSSSSSSSSSSSSSSSSSSSWWWWWWWSSSSSSSSSSSSSSSSWHFFFFFFPWWWWWWWSSSWFFFFFFFFFFFWSSSSWFFFFFFFFFFFFFFFWWSSSSSSSWWPPPPPPFFFPPPPWWWSSSSSSS
SSSSSSSSSSSSSSSSSSSWWWWWWWWWWFFFFFWWSSSSSSSSSSSSSSWWFFFFFPPWWSSSSSSSSSWWFFFFFFFFFWWSSSSWWFFFFFFFFFFFFFWWSSSSSSSWWPPPPPPPFFFPPPPPPWWSSSSSS
SSSSSSSSSSSSSSSSSSSWFFFFFFFFFFFFFFFWWSSSSSSSSSSSSWWFFFFFFPWWSSSSSSSSSSSWFFFFFFFFWWSSSSSSWWWFFFFFFFFFWWWSSSSSSSSWPPPPPPFFFFFFPPPPPPWWSSSSS
SSSSSSSSSWWWWWWSSWWWFFFFFFFFFFFFFFFFWSSSSSSSSSSSSWPFFFFFFWWSSSSSSSSSSSSWWWWWWWWWWSSSSSSSSSWWFFFFFWWWWSSSSSSSSSWWPPPPFFFFFFFFFPPPPPPWSSSSS
SSSSSSSSWWFFFFWWWWFFFFFFFFFFFFFFFFFFWSSSSSSSSSSWWWFFFFFFWWSSSSSSSSSSSSSSSSSSSSSSSSSSSSSSSSSWWWWWWWSSSSSSSSSSSSWPPPPFFFFFFFFFFFFPPPPWWSSSS
SSSSSSSSWFFFFFFFFFFFFFFFFFFFFFFFFFFFWSSSSSSSSSWWPFFFFFFWWSSSSSSSSSSSSSSSSSSSSSSSSSSSSSSSSSSSSSSSSSSSSSSSSSSSSWWPPPFFFFFFFFFFFFFFPPPPWSSSS
SSSSSSSWWFFFFFFFFFFFFFFFFFFFFFFFFFFFWSSSSSSSSWWPFFFFFHHWSSSSSSSSSSSSSSSSSSSSSSSSSSSSSSSSSSSSSSSSSSSSSSSSSSSSWWPPPFFFFFFFFFFFFFFFFPPPWWSSS
SSSSSSSWFFFFFFFFFFFFFFFFFFFFFFFFFFFFWSSSSSSSWWFFFFFHHHWWSSSSSSSSSSSSSSSSSSSSSSSSSSSSSSSSSSSSSSSSSSSSSSSSSSSSWPPPFFFFFFFFFFFFFFFFFFPPPWSSS
SSSSSSWWFFFFFFFFFFFFFFFFFFFWWWWWWWFFWSSSSSSSWFFFFFFHHWWSSSSSSSSSSSSSSSSSSSSSSSSSSSSSSSSSSSSSSSSSSSSSSSSSSSSSWPPPFFFFFFFFFFFFFFFFFFPPPWSSS
SSSSSSWFFFFFFFFFFFFFFFFFWWWWSSSSWWFFWSSSSSSSWFFFFFFWWWSSSSSSSSSSSSSSSSSSSSSSSSSSSSSSSSSSSSSSSSSSSSSSSSSSSSSSWPPFFFFFFFFFFFFFFFFFFFFPPWSSS
SSSSSSWFFFFFFFFFFFFFFWWWWSSSSSSSWFFFWSSSSSSSWWWWWWWWSSSSSSSSSSSSSSSSSSSSSSSSWWWWWWWWWWWSSSSSSSSSSSSSSSSSSSSSWPPFFFFFFFFFFFFFFFFFFFFPPWSSS
SSSSSSWFFFFFFFFFFFFFWWSSSSSSSSSWWFFFWSSSSSSSSSSSSSSSSSSSSSSSSSSSSSSSSSSSSSSWWFFFFFFFFFWWWWWSSSSSSSSSSSSSSSSSWPPFFFFFFFFFFFFFFFFFFFFPPWSSS
SSSSSSWWWFFFFFFFFFWWWSSSSSSSSWWWFFFFWWSSSSSSSSSSSSSSSSSSSSSSSSSSSSSSSSSSSSSWFFHHHHFFHFFFHFWWWSSSSSSSSSSSSSSSWFPFFFFFFFFFFFFFFFFFFFFPFWSSS
SSSSSSSSWWFFFFFFFFWSSSSSSSSWWWFFFFFFFWSSSSSSSSSSSSSSSSSSSSSSSSSSSSSSSSSSSSSWFFFHHFHHHFHHHFFFWWSSSSSSSSSSSSSSWPPFFFFFFFFFFFFFFFFFFFFPPWSSS
SSSSSSSSSWFFFFFFFFWWSSSSSWWWFFFFFFFFFWSSSSSSSSWWWWWWWSSSSSSSSSSSSSSSSSSSSSSWWFFHFFFFFFFHHHFFFWSSSSSSSSSSSSSSWPPFFFFFFFFFFFFFFFFFFFFPPWSSS
SSSSSSSSSWFFFFFFFFFWWWWWWWFFFFFFFFFFFWSSSSSSSWWFFFFFWWWSSSSSSSSSSSSSSSSSSSSSWWFHFHFHHHFFFFFFFWSSSSSSSSSSSSSSWPPPFFFFFFFFFFFFFFFFFFFPPWSSS
SSSSSSSSSWWFFFFFFFFFFFFFFFFFFFFFFFFFFWSSSSSSSWFFFFFFFFWWSSSSSSSSSSSSSSSSSSSSSWWWWFFFHFFHFHHFWWSSSSSSSSSSSSSSWPPPFFFFFFFFFFFFFFFFFFPPPWSSS
SSSSSSSSSSWWWFFFFFFFFFFFFFFFFFFFFFFFFWSSSSSSWWFFFFFFFFFWSSSSSSSSSSSSSSSSSSSSSSSSWWWFFFFFFFHWWSSSSSSSSSSSSSSSWWPPFFFFFFFFFFFFFFFFFFPPPWSSS
SSSSSSSSSSSSWWWFFFFFFFFFFFFFFFFFFFFFFWSSSSSSWFFFFFFFFFFWWWSSSSSSSSSSSSSSSSSSSSSSSSWWWFHHFHFWSSSSSSSSSSSSSSSSSWPPPFFFFFFFFEFFFFFFFPPPWWSSS
SSSSSSSSSSWWWWWFFFFFFFFFFFFFFFFFFFFFWWSSSSSWWFFFFFFFFFFFFWWWWWWSSSSSSSSSSSSSSSSSSSSSWFFFFFFWSSSSSSSSSSSSSSSSSWPPPPPFFFFFFFFFFFFFFPPPWSSSS
SSSSSSSSSSWFFFFFFFFFFFFFFFFFFFFWWWWWWSSSSSSWFFFFFFFFFFFFFFFFFFWWWWWWSSSSSSSSSSSSSSSSWWFFFFWWSSSSSSSSSSSSSSSSSWWPPPPPFFFFFFFFFFFPPPPWWSSSS
SSSSSSSSSSWFFFFFFFFFFFFFFFFWWWWWSSSSSSSSSSSWFFFFFFFFFFFFFFFFFFFFFFFWWWWWWWSSSSSSSSSSSWWWWWWSSSSSSSSSSSSSSSSSSSWWWPPPPPPPPPPPPPPPPPWWSSSSS
SSSSSSSSSWWFFFFFFFFFFFWWWWWWSSSSSSSSSSSSSSSWFFFFFFFFFFFFFFFFFFFFFFFFFFFFFWWWWSSSSSSSSSSSSSSSSSSSSSSSSSSSSSSSSSSSWWWPPPPPPPPPPPPPWWWSSSSSS
SSSSSSSSSWFFFFFFFFFWWWWSSSSSSSSSSSSSSSSSSSSWFFFFFFFFFFFFFFFFFFFFFFFFFFFFFFFFWWWWSSSSSSSSSSSSSSSSSSSSSSSSSSSSSSSSSSWWWWWPPPPPWWWWWSSSSSSSS
SSSSSSSSSWFFFFFFFWWWSSSSSSSSSSSSSSSSSSSSSSSWWFFFFFFFFFWWWWFFFFFFFFFFFFFFFFFFFFFWWWSSSSSSSSSSSSSSSSSSSSSSSSSSSSSSSSSSSSWWWWWWWSSSSSSSSSSSS
SSSSSSSSSWWFFFFFWWSSSSSSSSSSSSSSSSSSSSSSSSSSWWFFFFFFFFWSSWWFFFFFFFFFFFFFFFFFFFFFFWWWWWWWWWWWWSSSSSSSSSSSSSSSSSSSSSSSSSSSSSSSSSSSSSSSSSSSS
SSSSSSSSSSWWWWWWWSSSSSSSSSSSSSSSSSSSSSSSSSSSSWWFFFFFFFWSSWWFFFFFFFFFFFFFFFFFFFFFFFFFFFFFFFFFWSSSSSSSSSSSSSSSSSSSSSSSSSSSSSSSSSSSSSSSSSSSS
SSSSSSSSSSSWFFFWSSSSSSSSSSSSSSSSSSSSSSSSSSSSSSWWFFFFFFWWWWFFFFFFFFFFFFFFFFFFWWFFFFFFFFFFFFFFWSSSSSSSSSSSSSSSSSSSSSSSSSSSSSSSSSSSSSSSSSSSS
SSSSSSSSSSSWFFFWSSSSSSSSSSSSSSSSSSSSSSSSSSSSSSSWFFFFFFFFFFFFFFFFFFFFFFFFFFFFWWWFFFFFFFFFFFFWWSSSSSSSSSSSSSSSSSSSSSSSSSSSSSSSSSSSSSSSSSSSS
SSSSSSSSSSSWFFFWSSSSSSSSSSSSSSSSSSSSSSSSSSSSSSSWWFFFFFFFFFFFFFFFFFFFFFFFFFFFFWWWWFFFFFFFFFWWSSSSSSSSSSSSSSSSSSSSSSSSSSSSSSSSSSSSSSSSSSSSS
SSSSSSSSSSWWWWWWSSSSSSSSSSSSSSSSSSSSSSSSSSSSSSSSWWFFFFFFFFFFFFFFFFFFFFFFFFFFFFWWWFFFFFFFFWWSSSSSSSSSSSSSSSSSSSSSSSSSSSSSSSSSSSSSSSSSSSSSS
SSSSSSSWWWWFFFFWSSSSSSSSSSSSSSSSSSSSSSSSSSSSSSSSSWFFFFFFFFFFFFFFFFFFFFFFFFFFFFFFFFFFFFFFFWSSSSSSSSSSSSSSSSSSSSSSSSSSSSSSSSSSSSSSSSSSSSSSS
SSSSSSSWFFFFFFFWSSSSSSSSSSSSSSSSSSSSSSSSSSSSSSSSSWFFFFFFFFFFFFFFWWWWWWWWWWWWFFFFFFFFFFFFFWSSSSSSSSSSSSSSSSSSSSSSSSSSSSSSSSSSSSSSSSSSSSSSS
SSSSSSSWFFFFFWWWWWWWWSSSSSSSSSSSSSSSSSSSSSSSSSSSSWFFFFFFFFFFWWWWWSSSSSSSSSSWWFFFFFFFFFFFWWSSSSSSSSSSSSSSSSSSSSSSSSSSSSSSSSSSSSSSSSSSSSSSS
SSSSSSSWFFFFFWWWFFFFWWSSWWWWWWSSSSSSSWWWSSSSSSSSWWFFFFFFFFFWWSSSSSSSSSSSSSSSWWFFFFFFFFFWWSSSSSSSSSSSSSSSSSSSSSSSSSSSSSSSSSSSSSSSSSSSSSSSS
SSSSSSSWFFFFFFFFFFFFFWWWWFFFFWWWWWSWWWFWSSSSSSWWWFFFFFFFFFFWSSSSSSSSSSSSSSSSSWFFFFFFFWWWSSSSSSSSSSSSSSSSSSSSSSSSSSSSSSSSSSSSSSSSSSSSSSSSS
SSSSSSSWWFFFFFFFFFFFFFFFFFFFFFFFFWWWFFFWSSSSSWWFFFFFFFFFFFFWSSSSSSSSSSSSSSSSSWFFFFFFFWSSSSSSSSSSSSSSSSSSSSSSSSSSSSSSSSSSSSSSSSSSSSSSSSSSS
SSSSSSSSWWWFFFFFFFFFFFFFFFFFFFFFFFFFFFFWSSSSWWFFFFFFFFFFFFWWWWSSSSSSSSSSSSSSSWFFFFFWWWSSSSSSSSSSSSSSSSSSSSSSSSSSSSSSSSSSSSSSSSSSSSSSSSSSS
SSSSSSSSSSWWFFFFFFFFFFFFFFFFFFFFFFFFFFFWSSSSWFFFFFFFFFFFFWWFFWWSSSSSSSSSSSSSSWWWWWWWSSSSSSSSSSSSSSSSSSSSSSSSSSSSSSSSSSSSSSSSSSSSSSSSSSSSS
SSSSSSSSSSSWWWFFFFFFFFFFFFFFFFFFFFFFFFFWSSSSWWFFFFFFFFFFFWWFFFWWWSSSSSSSSSSSSSSSSSSSSSSSSSSSSSSSSSSSSSSSSSSSSSSSSSSSSSSSSSSSSSSSSSSSSSSSS
SSSSSSSSSSSSSWFFFFFFFFFFFFFFFFFFFFFFFFFWSSSSSWFFFFFFFFFFFWWFFFFFWSSSSSSSSSSSSSSSSSSSSSSSSSSSSSSSSSSSSSSSSSSSSSSSSSSSSSSSSSSSSSSSSSSSSSSSS
SSSSSSSSSSSSSWFFFFFWWWWWWWWFFFFFFFFFFFWWSSSSSWWFFFFFFFFFFFFFFFFFWSSSSSSSSSSSSSSSSSSSSSSSSSSSSSSSSSSSSSSSSSSSSSSSSSSSSSSSSSSSSSSSSSSSSSSSS
SSSSSSSSSSSSSWWWWWWWSSSSSSWWWWFFFFFFFFWSSSSSSSWWFFFFFFFFFFFFFFFFWSSSSSSSSSSSSSSSSSSSSSSSSSSSSSSSSSSSSSSSSSSSSSSSSSSSSSSSSSSSSSSSSSSSSSSSS
SSSSSSSSSSSSSSSSSSSSSSSSSSSSSWWWWFFFFFWSSSSSSSSWWFFFFFFFFFFFWWWWWSSSSSSSSSSSSSSSSSSSSSSSSSSSSSSSSSSSSSSSSSSSSSSSSSSSSSSSSSSSSSSSSSSSSSSSS
SSSSSSSSSSSSSSSSSSSSSSSSSSSSSSSSWWWWWWWSSSSSSSSSWWWWWWWWWWWWWSSSSSSSSSSSSSSSSSSSSSSSSSSSSSSSSSSSSSSSSSSSSSSSSSSSSSSSSSSSSSSSSSSSSSSSSSSSS