DEFAULT
48.0,11.0
84,7;85,11;98,3;54,12;71,14;97,18;81,31;68,20;64,36;92,8;94,9;92,6;94,5;96,6;96,8;86,9;88,9;94,7;75,3;79,7;76,15;82,18;91,17;94,20;93,23;82,23;78,25;73,28;74,32;70,35;64,33;62,26;63,20;66,28;
SSSSSSSSSSSSSSSSSSSSSSSSSSSSSSSSSSSSSSSSSSSSSSSSSSSSSSSSSSSSSSSSSSSSSSSSSWWWWWWSSSSSSSSSSSSSSSSSSSSSS
SSSSSSSSSSSSSSSSSSSSSSSSSSSSSSSSSSSSSSSSSSSSSSSSSSSSSSSSSSSSSSSSSSWWWWWWWWHHFFWWWSSSSSSSSSSSSSSSSSSSS
SSSSSSSSSSSSSSSSSSSSSSSSSSSSSSSSSSSSSSSSSSSSSSSSSSSSSSSSSSSSSSSSSSWFFFFFFFFFFFFFWSSSSSSSSSSSSSSSSSSSS
SSSSSSSSSSSSSSSSSSSSSSSSSSSSSSSSSSSSSSSSSSSSSSSSSSSSSSSSSSSSSSSSSSWFFFFFFFFFFFFFWWWWWWWWWWWWWWWWWWWSS
SSSSSSSSSSSSSSSSSSSSSSSSSSSSSSSSSSSSSSSSSSSSSSSSSSSSSSSSSSSSSSSSSSWFFWWWFFFFFFFFFFFWWHFFFFFFFFFFFFWSS
SSSSSSSSSSSSSSSSSSSSSSSSSSSSSSSSSSSSSSSSSSSSSSWWWWWWSSSSSSSSSSSSSSWFFWSWWFFFFFFFFFFWWFFFFFFFFFFFFFWSS
SSSSSSSSSSSSSSSSSSSSSSSSSSSSSSSSSSSSSSSSSSSSSWWFFFFWWSSSSSSSSSWWWWWFFWSSWWWFFFFFFFFFWFFFFFFFFFFFFFWSS
SSSSSSSSSSSSSSSSSSSSSSSSSSSSSSSSSSSSSSSSSSSSSWFFHHHFWWWWWWWWWWWFFFFFFWSSSSWFFFFFFFFFDFFFFFFFFFFFFFWSS
SSSSSSSSSSSSSSSSSSSSSSSSSSSSSSSSSSSSSSSSSSSSSWFFHHHFFFFFFFFFFFFFFFFFFWSSSSWFFFFFFFFFWFFFFFFFFFFFFFWSS
SSSSSSSSSSSSSSSSSSSSSSSSSSSSSSSSSSSSSSSSSSSSSWFFFFFFFFFFFFFFFFFFFWWWWWSSSSWFFFFFFFFFWFFFFFFFFFFFFFWSS
SSSSSSSSSSSSSSSSSSSSSSSSSSSSSSSSSSSSSSSSSSSSSWFFFFFFFFFFFFFFFWWWWWSSSSSSSSWFFFFFWWWWWFFFFFFFFFFFFFWSS
SSSSSSSSSSSSSSSSSSSSSSSSSSSSSSSSSSSSSSSSSSSSSWFFFFFFFFFFFFFFFWSSSSSSSSSWWWWFFHHHWWSSWWWWWWWWWWWWWWWSS
SSSSSSSSSSSSSSSSSSSSSSSSSSSSSSSSSSSSSSSSSSSSSWFFFFFFFFFFFFFFFWSSSSSSSWWWFFFFFFFFFWSSSSSSSSSSSSSSSSSSS
SSSSSSSSSSSSSSSSSSSSSSSSSSSSSSSSSSSSSSSSSSSSSWFFHHHFFFFFWWWWWWSSSSSSSWFFFFFFFFFFFWSSSSSSSSSSSSSSSSSSS
SSSSSSSSSSSSSSSSSSSSSSSSSSSSSSSSSSSSSSSSSSSSSWWFHHHFFFFFWSSSSSSSSSSSSWFFFFFFFFFFFWWWWWWSSSWWWWSSSSSSS
SSSSSSSSSSSSSSSSSSSSSSSSSSSSSSSSSSSSSSSSSSSSSSWFFFFFWWWWWSSSSSSSSSSSSWFFFFFFFFFFFFFFFFWWWWWFFWSSSSSSS
SSSSSSSSSSSSSSSSSSSSSSSSSSSSSSSSSSSSSSSSSSSSSSWWWWWWWSSSSSSSSSSSSSSSSWWWWWFFFFFFFFFFFFFFFFFFFWWWWWWWS
SSSSSSSSSSSSSSSSSSSSSSSSSSSSSSSSSSSSSSSSSSSSSSSSSSSSSSSSSSSSSSSSSSSSSSSSSWFFFFFFFFFFFFFFFFFFFFFFFFFWS
SSSSSSSSSSSSSSSSSSSSSSSSSSSSSSSSSSSSSSSSSSSSSSSSSSSSSSSSSSSSSWWWWWWWWWSSSWWWPPFFFFFFFFFFWWFFFFFFFFFWS
SSSSSSSSSSSSSSSSSSSSSSSSSSSSSSSSSSSSSSSSSSSSSSSSSSSSSSSSSSSSWWFFFFFFFWWSSSSWWPPFFFFFFFFHWWFFFFFFFFFWS
SSSSSSSSSSSSSSSSSSSSSSSSSSSSSSSSSSSSSSSSSSSSSSSSSSSSSSSSSSSSWFFFFFFFFFWSSSSSWPPFFFFFFFFFFFFFFFFFFFFWS
SSSSSSSSSSSSSSSSSSSSSSSSSSSSSSSSSSSSSSSSSSSSSSSSSSSSSSSSSSSSWFFFFFFFFFWWSSSWWPPFFFFFFFWWWFFFFFFFFWWWS
SSSSSSSSSSSSSSSSSSSSSSSSSSSSSSSSSSSSSSSSSSSSSSSSSSSSSSSSSSSSWFFFFFFFFFFWSSSWPPPFFFFFHHWWWFFFFFFFFWWSS
SSSSSSSSSSSSSSSSSSSSSSSSSSSSSSSSSSSSSSSSSSSSSSSSSSSSSSSSSSSSWFFWWWWWFFFWWSSWPPFFFFFFHHWWFFFFFFFFFFWSS
SSSSSSSSSSSSSSSSSSSSSSSSSSSSSSSSSSSSSSSSSSSSSSSSSSSSSSSSSSSSWFFWWWWWFFFFWSSWPFFFFFFFHWWWFFFFFFFFFWWSS
SSSSSSSSSSSSSSSSSSSSSSSSSSSSSSSSSSSSSSSSSSSSSSSSSSSSSSSSSSSWWFFFFFFFFFFFWWWWFFFFFFFFFWWWFWWWWWWWWWSSS
SSSSSSSSSSSSSSSSSSSSSSSSSSSSSSSSSSSSSSSSSSSSSSSSSSSSSSSSSSSWFFFFFFFFFFFFFFFFFFFFFFFFFFFFFWSSSSSSSSSSS
SSSSSSSSSSSSSSSSSSSSSSSSSSSSSSSSSSSSSSSSSSSSSSSSSSSSSSSSSSSWHFFFFFFFFFFFFFFFFFFFFFFFFFFFFWSSSSSSSSSSS
SSSSSSSSSSSSSSSSSSSSSSSSSSSSSSSSSSSSSSSSSSSSSSSSSSSSSSSSSSSWHFFFFFFFFFFFFFFFFFFFFFFWWWWWWWSSSSSSSSSSS
SSSSSSSSSSSSSSSSSSSSSSSSSSSSSSSSSSSSSSSSSSSSSSSSSSSSSSSSSSSWFFFEFFFFFFFFFFFFHHHFFFFWSSSSSSSSSSSSSSSSS
SSSSSSSSSSSSSSSSSSSSSSSSSSSSSSSSSSSSSSSSSSSSSSSSSSSSSSSSSSSWFFFFFFFFFWWWFFFFHHHFFFFWSSSSSSSSSSSSSSSSS
SSSSSSSSSSSSSSSSSSSSSSSSSSSSSSSSSSSSSSSSSSSSSSSSSSSSSSSSSSSWWWFFFFFFFWWWFFFFFHFFFFFWSSSSSSSSSSSSSSSSS
SSSSSSSSSSSSSSSSSSSSSSSSSSSSSSSSSSSSSSSSSSSSSSSSSSSSSSSSSSSSSWFFFFFFFFFFFFFFFFFFFFFWSSSSSSSSSSSSSSSSS
SSSSSSSSSSSSSSSSSSSSSSSSSSSSSSSSSSSSSSSSSSSSSSSSSSSSSSSSSSSSSWFFFFFFFFFFFFFFFFFWWWWWSSSSSSSSSSSSSSSSS
SSSSSSSSSSSSSSSSSSSSSSSSSSSSSSSSSSSSSSSSSSSSSSSSSSSSSSSSSSSSSWWFFFFWWFFFFFFFFFWWSSSSSSSSSSSSSSSSSSSSS
SSSSSSSSSSSSSSSSSSSSSSSSSSSSSSSSSSSSSSSSSSSSSSSSSSSSSSSSSSSSSSWFFFFWWFFFFWWWWWWSSSSSSSSSSSSSSSSSSSSSS
SSSSSSSSSSSSSSSSSSSSSSSSSSSSSSSSSSSSSSSSSSSSSSSSSSSSSSSSSSSSSSWFFFFFFFFFFWSSSSSSSSSSSSSSSSSSSSSSSSSSS
SSSSSSSSSSSSSSSSSSSSSSSSSSSSSSSSSSSSSSSSSSSSSSSSSSSSSSSSSSSSSSWFFFFFFFFFFWSSSSSSSSSSSSSSSSSSSSSSSSSSS
SSSSSSSSSSSSSSSSSSSSSSSSSSSSSSSSSSSSSSSSSSSSSSSSSSSSSSSSSSSSSSWWWWWFFFFHWWSSSSSSSSSSSSSSSSSSSSSSSSSSS
SSSSSSSSSSSSSSSSSSSSSSSSSSSSSSSSSSSSSSSSSSSSSSSSSSSSSSSSSSSSSSSSSSWWFWWHWSSSSSSSSSSSSSSSSSSSSSSSSSSSS
SSSSSSSSSSSSSSSSSSSSSSSSSSSSSSSSSSSSSSSSSSSSSSSSSSSSSSSSSSSSSSSSSSSWWWWWWSSSSSSSSSSSSSSSSSSSSSSSSSSSS