DEFAULT
1, 1
2,2;
WWWWWWWWWWWW
WFFFFFFFFFFW
WFFFFFFFFFFW
WFFFFFFFFFFW
WFFFFFFFFFFW
WFFFFFFFFFEW
WFFFFFFFFFFW
WFFFFFFFFFFW
WFFFFFFFFFFW
WWWWWWWWWWWW
