Version: 2
DEFAULT
7.0,7.0
door:1.0,3.0;amg:3.0,8.0;plate:1.0,13.0;lever:6.0,13.0;laser:7.0,3.0;sphere:8.0,2.0

WWWWWWWWWWWWWWWW
TFFGFFFFFFFFFFFW
TFFGFFFFFFFFFFFW
TFFWPPPPPPPPFFFW
WFFWPPPPPPPPFFWW
GGGWPPTTTPPPFFTW
TFFFPPFFFPPPFFTW
TFFFPPFFFPPPFFWW
TFFFPPFFFPPPFFFW
WFFFPPPPPPPPWWWW
WFFWPPPPPPPPPPPP
WDWWPPWFFFWPPPPP
WFWWPPWFFFWPPPPP
WEWWPPWFFFWPPPPP
WWWWPPWTTTWPPPPP
