Version: 2
DEFAULT
3.0,1.0
door1:1.0,3.0;door2:2.0,3.0;door3:4.0,3.0;door4:6.0,3.0;door5:7.0,3.0;door6:7.0,4.0;door7:7.0,5.0;door8:7.0,6.0;door9:7.0,7.0

PPPPPPWWWWWWWWWWWWWWWWWEWWWWPPPPPPP
PPPPPWWPPPPPPPPWPPPPPPFFFPPWWPPPPPP
PPPPWWPPFFFFFFFWFPPPPPFFFFPPWWPPPPP
PPPWWPPFFFFFFFFDFFFPPPPFFFFPPWWPPPP
PPWWPPFFFFFFFFFWFFFFPPPPPFFFPPWWPPP
PWWPPFFFFPPPPPPWPFFFFPPPPPFFFPPWWPP
WWPPFFFFPPWWWWWWPPFFFFPPPPPFFFPPWWP
WPPFFFFPPWWPPPPPPPPFFFFPPPPPFFFPPWP
WPFFFFPPWWPPPPPPPPPPFFFPPPPPPFFFPWP
WPFFFPPWWPPPPPPPPPPPFFFPPPPPPFFFPWP
WPFFFPWWPPPPPPPPPPPPFFFPPPPPPFFFPWP
WPFFFPWPPPPPPPPPPPPFFFPPPPPPPFFFPWP
WPFFFPWPPPPPPPPPPPFFFPPPPPPPPFFFPWP
WWWDWWWPPPPPPPPPPFFFPPPPPPPPPFFFPWP
WPFFFPWPPPFFFFFFFFFPPPPPPPPPFFFFPWP
WPFFFPWPPFFFFFFFFFPPPPPPPPPFFFFPPWP
FFFFFFFFFFFFFFFFFPPPPPPPPPFFFFPPWWP
FFFFFFFFFFFFFFFFFPPPFFFFFFFFFPPWWPP
FFFFFFFFFFFFFFFFFPPFFFFFFFFFPPWWPPP
FFFFFFFFFFFFFFFFFPFFFFFFFFFPPWWPPPP
FFFFFFFFFFFFFFFFFFFFFPPPPPPPWWPPPPP
FFFFFFFFFFFFFFFFFFFFPPWWWWWWWPPPPPP
FFFFFFFFFFFFFFFFFFFWWWWPPPPPPPPPPPP
FFFFFFFFFFFFFFFFFWWPPPPPPPPPPPPPPPP
WTTWWWWWWWWWWWWWWWWWWPPPPPPPPPPPPPP
