Version: 2
DEFAULT
3.0,1.0
door:13.0,5.0;plate:8.0,6.0;cube:11.0,2.0

WWWWWWWWWWWWWWWW
WWWWWWWWWWWWWFFW
WWWWWWWWWWWWWEFW
WWWWWWWWWWWWWFFW
WWFFFFFFFFFWFFFW
WWFFFFFFFFFWFFFW
WWFFFFFFFFFWWDWW
WWFFFFWWWWWWFFFW
WWFFFFFFFFFFFFFW
WWFFFFFFFFFFFFFW
WWFFFFFFFFFFFFFW
WWWWWWWWWWWWWWWW
