Version: 2
DEFAULT
10.0,2.0
switch:8.0,5.0

WWWWWWWWWWWWW
WFEFFWFFFFFFW
WFFFFDFFFFFFW
WFFFFWFFFFFFW
WFFFFWFFFFFFW
WFFFFWFFFFFFW
WWWWWWWWWWWWW
