Version: 2
DEFAULT
1.0,3.0
monster1:3.0,8.0;monster5:8.0,12.0;monster4:8.0,10.0;monster3:7.0,8.0;monster2:5.0,8.0;emitter:12.0,16.0;monster6:8.0,14.0;switch:1.0,6.0

WWWWWWWWWWWWWWW
WWWWWWWWWWFEFFW
WWWWWWWWWWFFFFW
WWWWWWWWFFFFFFW
WWWWWWWWWWFFFFW
WWWWWWWWFFFFFFW
WWWWWWWWWWFFFFW
WWWWWWWWFFFFFFW
WWWWWWWWWWFFFFW
WWWFWFWFWWFFFFW
WWWFWFWFWWFFFFW
WFFFFFFFFFFFFFT
WFFFFFFFFFFFFFT
WFFFFFFFFFFFFFT
WFFFFFFFFFFFFFT
WFFFFFFFFFFFFFT
WFFFFFFFFFFFFFW
WWWWWWWWWWTTTWW
