Version: 2
DEFAULT
2.0,2.0
bridge:3.0,2.0;switch:4.0,1.0

WTTWWWWWWWWWWWWWWTTW
TFFFPPPPPPPPPPPPPFFT
TFFWWWWWWWWWWWWWWFFT
WPPWWWWWWWWWWWTTWPPW
WPPWTFFPPPPPPPFFTPPW
WPPWTFFPPPPPPPFFTPPW
WPPWFFFPPPPPPPPPWPPW
WPPWFEFPPPPPPPPPWPPW
WPPWWWWWWWWWPPPPWPPW
WPPWWWWWWWWWPPPPWPPW
WFFFPPPPPPPPPPFFTPPW
WFFFPPPPPPPPPPFFTPPW
WWWWWWWWWWWWWWTTWPPW
WWWWWWWWWWWWWWWWWFFW
WFFFFPPPPPPPPPPFFFFT
WFFFFPPPPPPPPPPFFFFW
WWWWWWWWWWWWWWWWWTTW
