Version: 2
DEFAULT
3.0,9.0
spawner:18.0,3.0;plate:1.0,10.0;cube:18.0,1.0;laser:3.0,7.0;portal1:5.0,11.0;portal2:23.0,2.0

WWWWWTWWSSSSSSSSSSSSSSSS
WFFFFFFWSSSSSSSSSSSSSSSS
WFFFFFFWSSSSSSSSSSSSSSSS
WFFFFFFWSSSSSSSSSSSSSSSS
WWWFWWWWSSSSSSSSSSSSSSSS
SSWFWSSSSSSSSSSSSSSSSSSS
SSWFWSSSSSSSSSSSSSSSSSSS
SSWFWSSSSSSSSSSSWWWWWWWW
SSWFWSSSSSSSSSSSWFFFFFFW
SSWEWSSSSSSSSSSSWFFFFFFT
SSWWWSSSSSSSSSSSWFFFFFFW
SSSSSSSSSSSSSSSSWWWWWWWW
