Version: 2
DEFAULT
3.0,16.0
Energie:7.0,9.0;Traktor2:21.0,14.0;Traktor1:13.0,14.0;Brücke2:25.0,14.0;Grid3:23.0,4.0;Brücke1:15.0,14.0;Grid2:22.0,4.0;Grid5:25.0,4.0;Grid4:24.0,4.0;Grid1:21.0,4.0;Wand3:18.0,10.0;Wand2:23.0,14.0;Wand1:17.0,14.0;Würfel1:8.0,17.0;Anti1:21.0,6.0;Energie2:7.0,7.0;Lever0:12.0,16.0;Kugel1:8.0,15.0;Lever1:13.0,16.0;Anti5:25.0,6.0;Anti4:24.0,6.0;Anti3:23.0,6.0;Anti2:22.0,6.0;Lever8:27.0,6.0;spherePlate1:5.0,14.0;Lever9:27.0,4.0;Lever6:25.0,16.0;Lever7:19.0,11.0;CubePlate1:5.0,16.0;Lever4:21.0,16.0;Lever5:23.0,16.0;Lever2:15.0,16.0;Lever3:17.0,16.0
WindowBarred:12.0,21.0
WWWWWWWWWWWWWWWWWWWWWWWWWWWWWWWWWWWWWWWWWWWWWWWW
WFFFFFFFFFFFFFFFFFFFFFFFFFFFFFFFFFFFFFFFFFFFFFFW
WFFFFFFFFFFFFFFFFFFFFFFFFFFFFFFFFFFFFFFFFFFFFFFW
WFFFFFFFFFFFFFFFFFFFFFFFFFFFFFFFFFFFFFFFFFFFFFFW
WFFFFFFFFFFFFFFFFFFFFFFFFFFFFFFFFFFFFFFFFFFFFFFW
WFFFFFFFFFFFFFFFFFFFFFFFFFFFFFFFFFFFFFFFFFFFFFFW
WFFFFFFFFFFFFFFFFFFFTGGGGGGFFFFFFFFFFFFFFFFFFFFW
WFFFFFFFFFFFFFFFFFFFFFFFFFFFFFFFFFFFFFFFFFFFFFFW
WFFFFFFFFFFFFFFFFFFTFFFFFFFFFFFFFFFFFFFFFFFFFFFW
WFFFFFFFFFFFFFFFFFFTLLLLLLLFFFFFFFFFFFFFFFFFFFFW
WFFFFFFFFFFFFFFFFFFTFFFFFFFFFFFFFFFFFFFFFFFFFFFW
WFFFFFFFFFFFFFFFFFFTFFFFFFWFFFFFFFFFFFFFFFFFFFFW
WFFFFFFFFFTTTTTTTTWWWFFFFFWFFFFFFFFFFFFFFFFFFFFW
WFFFFFFFFFFFFFFFFFWWWFFFFFWFFFFFFFFFFFFFFFFFFFFW
WFFFFFFFFFFFFFFFFFWWWFFFFFWFFFFFFFFFFFFFFFFFFFFW
WFFFFFFFFFWWWWWWWWWWWFFFFFWFFFFFFFFFFFFFFFFFFFFW
WFFFFFFFFFFFFFFFFFFFWWWWWWWFFFFFFFFFFFFFFFFFFFFW
WFFFFFFFFFFFFFFFFFFFFFFFFFFFFFFFFFFFFFFFFFFFFFFW
WWWWWWWWWWWWWTTTTTWWWTTTTTWWWWWWWWWWWWWWWWWWWWWW
