Version: 2
DEFAULT
1.0,1.0
portal:12.0,3.0;amg:1.0,10.0

WWWWPPPPPPPPPPPP
WFFFPPPPPPPPPPPP
WFEFPPPPPPPPPPPP
WFFFPPPPPPPPPPPP
WWFFPPPPPPPPPPPP
WTFFPPPPPPPPPPPP
WTFFPPPPPWWWWPPP
WWFFPPPPPFFFTPPP
WPPPPPPPPFFFTPPP
WPPPPPPPPFFFTPPP
WTTTPPPPPFFFTPPP
WFFFPPPPPFFFTPPP
WFFFPPPPPFFFTPPP
WWWWPPPPPWWWWPPP
