Version: 2
DEFAULT
2.0,9.0
portal1:3.0,14.0;portal2:18.0,2.0

WWTTTWWPPPPPPPPPPPP
WFFFFFWPPPPPPPPPPPP
WFFFFFWPPPPPPPPPPPP
WFFFFFWPPPPPPPPPPPP
WFFFFFWPPPPPPPPPPPP
WFFFFFWPPPPPPPPPPPP
WWWWWWWPPPPPPPPPPPP
WPPPPPPPPPPPPPPPPPP
WPPPPPPPPPPPPPPPPPP
WPPPPPPPWWWWPPPPPPW
WEFPPPPPFFWWWWWWWWW
WFFPFFFPFFFFFFFFFFW
WFFPFPFFFFFFFFFFFFT
WFFFFPPPPPPFFFFFFFW
WWWWWWWWWWWWWWWWWWW
