Version: 2
DEFAULT
2.0,5.0
portal:0.0,10.0

WWTTTWWWWWWWTTTWWWW
WFFFFFFFPPPFFFFFEFW
WFFFFFFFPPPFFFFFFFW
TFFFFFFFPPPFFFFFFFW
TFFFFFFFPPPFFFFFFFT
TFFFFFFFPPPFFFFFFFT
TFFFFFFFPPPFFFFFFFT
WFFFFFFFPPPFFFFFFFT
WFFFFFFFPPPFFFFFFFT
WFFFFFFFPPPFFFFFFFT
WFFFFFFFPPPFFFFFFFT
WFFFFFFFPPPFFFFFFFT
WFFFFFFFPPPFFFFFFFW
WFFFFFFFPPPFFFFFFFW
WWTTTWWWWWWWWTTTTWW
