Version: 2
DEFAULT
2.0,9.0
portal1:4.0,14.0;portal2:13.0,14.0

WWTTTWWWWWWWTTTWWWW
WFFFFFFPPPFFFFFFFFW
WFFFFFFPPPFFFFFFFFW
WFFFFFFPPPFFFFFFFFW
WFFFFFFPPPPPFFFPPPW
WFFFFFFPPPPPFFFPPPW
WFFFFFFPPPPPFFFPPPW
WPPPPPPPPPPPFFFPPPW
WPPPPPPPPPPPFFFPPPW
WPPPPPFPPPPPFFFPPPW
WEFPPPFPFFFPFFFPPPW
WFFPFFFPFPFPPPFPPPW
WFFPFPFFFPFFPFFPPPW
WFFFFPPPPPPFFFPPPPW
WWWWWWWWWWWWWWWWWWW
