Version: 2
DEFAULT
5.0,9.0
portal:18.0,10.0;lever:11.0,2.0

WWTTTWWWWWWWWWWWWWW
WFFFFFFPPPPFFFFFFFW
TFFFFFFPPPPFFFFFFFT
TFFFFFFPPPPFFFFFFFT
TFFFFFFPPPPFFFFFFFT
TFFFFFFPPPPFFFFFFFW
WFFFFFFPPPPPPPPPPPW
WFFFPPPPPPPPPPPPPPW
WFFFPPPPPPPPPPPPPPW
WFFFPPPPPPPPPPPPPPW
WFFFPPPPPPFFFFFFFFT
WFFFPPPPPPFFFFFFFFT
WFEFPPPPPPFFFFFFFFT
WWWWWWWWWWTTTTTTTWW
