Version: 2
DEFAULT
1.0,3.0
monster1:3.0,8.0;monster5:8.0,12.0;monster4:8.0,10.0;monster3:7.0,8.0;monster2:5.0,8.0;emitter:12.0,16.0;monster6:8.0,14.0

PPPPPPPPPWWWWWW
PPPPPPPPPWFEFFW
PPPPPPPWWWFFFFW
PPPPPPPWFFFFFFW
PPPPPPPWWWFFFFW
PPPPPPPWFFFFFFW
PPPPPPPWWWFFFFW
PPPPPPPWFFFFFFW
PPWWWWWWWWFFFFW
PPWFWFWFWWFFFFW
WWWFWFWFWWFFFFW
TFFFFFFFFFFFFFW
TFFFFFFFFFFFFFW
TFFFFFFFFFFFFFW
WFFFFFFFFFFFFFW
WFFFFFFFFFFFFFW
WFFFFFFFFFFFFFW
WWWWWWWWWWTTTWW
