Version: 2
DEFAULT
2.0,3.0
turret1:5.0,8.0;wall:11.0,8.0;turret3:7.0,8.0;turret2:6.0,8.0

WWWWWWWWWWWWW
WWWWWFFFWFEFW
WWWWWPPPWFFFW
WFFFFFFFFFFFT
WFFFFFFFFFFFT
WFFFFFFFFFFFT
WFFFFFFFFFFFT
WFFFFFFFFFFFT
WFFFFFFFFFFFW
WWWWWWWWWTTTW
