Version: 2
DEFAULT
3.0,11.0
cube:5.0,10.0;lever:17.0,10.0;bridge:19.0,1.0;pressurePlate:16.0,2.0

WWTTTTTWWWWWWTTTTTWWW
WFFFFFFFPPPFFFFFFFFFW
TFFFFFFFPPPFFFFFFFFFT
TFFFFFFFPPPFFFFFFFFFT
TFFFFFFFPPPFFFFFFFFFT
TFFFFFFFPPPFFFFFFFFFT
WFFFFFFFPPPFFFFFFFFFW
WPPPPPPPPPPPPPPPPPPPW
WPPPPPPPPPPPPPPPPPPPW
WPPPPPPPPPPPPPPPPPPPW
WFFFFFFFPPPFFFFFFFFFT
WEFFFFFFPPPFFFFFFFFFT
WFFFFFFFPPPFFFFFFFFFT
WFFFFFFFPPPFFFFFFFFFW
WWWWWWWWWWWWWTTTTTWWW
