Version: 2
DEFAULT
2.0,6.0
pressurePlate:13.0,4.0;cube:4.0,8.0

WWWWWWWWWWWWWTTTWW
WFFFFFFPPPPPFFFFFW
WFFFFFFPPPPPFFFFFT
WFFFFFFPPPPPFFFFFT
WFFFFFFPPPPPFFFFFT
WFFFFFFPPPPPFFFFFT
WFFFFFFPPPPPFFFFFT
WFFFFFFPPPPPFFFFFW
WFFFFFFPPPPPFFFFFW
WFFFFFFPPPPPFFFEFW
WWTTTTWWWWWWWWWWWW
