Version: 2
DEFAULT
2.0,1.0
door:7.0,4.0;plate:4.0,5.0;amg:9.0,5.0;spawner:3.0,1.0;cube:1.0,7.0

WWWWSSSSSSSSW
WFFWSSSSSSSSW
WFFWWWWWWSSSW
WFFFFFFWWWWWW
WFFFFFFWFFFFW
WFFFFFFDFFEFW
WFFFFFFWFFFFW
WFFFWWWWWWWWW
WFFFWSSSSSSSS
WWWWWSSSSSSSW
