TEMPLE
3,7
28,13;16,15;19,15;22,15;25,15;28,15;
PPPPPPPPPPPPPPPPPPPPPPPPPPPPWWWWWPPPPPPPPPPPPPPP
PPPPPPPPPPPPPPPPPPPPPPPPPPPWWFFEWPPPPPPPPPPPPPPP
PPPPPPPPPPPPPPPPPPPPPPPPPPPWFFWWWPPPPPPPPPPPPPPP
PPPPPPPPPPPPPPPPPPPPPPPPPPPWFWWPPPPPPPPPPPPPPPPP
PPWWWWWWWPPPPPPPPPPPPPPPPPPWFWPPPPPPPPPPPPPPPPPP
PWWFFFFFWWWWWWWPPPPPPPPPPPPWFWPPPPPPPPPPPPPPPPPP
WWFFFFFFFFFFFFWWPPPPPPPPPPPWFWPPPPPPPPPPPPPPPPPP
WFFFFFFFFFFFFFFWWPPPPPPPPPWWFWWWWWWWWWPWWWWWWWPP
WFFFFFFFFFFFFFFFWWWWWWWWWWWWDWWWWFFFWWPWFFFFFWWP
WWFFFFFFFFFFFFFFFFFFFFFFFFFFFFWWFFFFFWPWFFFFFFWP
PWWWWWWWFFFFFFFFFFFFFFFFFFFFFFWFFFFFFWWWFFFFFFWP
PPPPPPPWWWWWWFFFFFFFFFFFFFFFFFWFFFFFFDFFFFFFFFWP
PPPPPPPPPPPPWWFFFFFFFFFFFFFFFFWWFFFFFWWWFFFFFFWP
PPPPPPPPPPPPPWWFFFFFFFFFFFFFFWWWWFFFWWPWFFFFFWWP
PPPPPPPPPPPPPPWWWWWWWWWWWWWWWWWPWWDWWPPWWWWWWWPP
PPPPPPPPPPPPPPPWFFWFFWFFWFFWFFWPPWFWPPPPPPPPPPPP
PPPPPPPPPPPPPPPWFFWFFWFFWFFWFFWWWWFWPPPPPPPPPPPP
PPPPPPPPPPPPPPPWFFFFFFFFFFFFFFFFFFFWPPPPPPPPPPPP
PPPPPPPPPPPPPPPWWWWWWWWWWWWWWWWWWWWWPPPPPPPPPPPP
