DEFAULT
7, 1

WWWWWWWTTWWWWWWWWW
WFFFFFFFFFFFFFFFFW
WFFFFFFFFFFFFFFFFT
TFFFFFFFFFFFFFFFFT
WFFFFFFFFFFFFFFFFW
TFFFFFFFFFFFFFFFFW
TFFFFFFFFFFFFFFFFW
WFFFFFFFFFFFFFFFFW
WFFFFFWWTWWFFFFFFW
WFFFFFFFFFFFFFFFFW
WFFFFFFFFFFFFFFFFW
WFFFFFFFFFFFFFFFFW
WFFFFFFFFFFFFFFFFW
WFFFFFFFFFFFFFFFFW
WWWWWWWWWWWWWTTWWW
