DEFAULT
7, 1

WWWWWWWBBWWWWWWWWW
WFFFFFFFFFFFFFFFFW
WFFFFFFFFFFFFFFFFB
BFFFFFFFFFFFFFFFFB
WFFFFFFFFFFFFFFFFW
GFFFFFFFFFFFFFFFFW
GFFFFFFFFFFFFFFFFW
WFFFFFFFFFFFFFFFFW
WFFFFFFFFFFFFFFFFW
WFFFFFFFFFFFFFFFFW
WFFFFFFFFFFFFFFFFW
WFFFFFFFFFFFFFFFFW
WFFFFFFFFFFFFFFFFW
WFFFFFFFFFFFFFFFFW
WWWWWWWWWWWWWBBWWW
