DEFAULT
7, 1

WWWWWWWWWWWWWWWWWW
WFFFFFFFFFFFFFFFFW
WWWFFFFFFFFFFFFFFW
WFFFFFFFFFFFFDFFFW
WWWFFFFFFFFFFFFFFW
WFFFFFFFFFFFFFFFFW
WFFFFFFFFFFFFFFFFW
WFFFFFFFFFFFFFFFFW
WFFFFFWWWWWWFFFFFW
WFFFFFFFFFFFFFFFFW
WFFFFFFFFFFFFFFFFW
WFFFFFFFFFFFFFFFFW
WFFFFFFFFFFFFFFFFW
WFFFFFFFFFFFFFFFFW
WWWWWWWWWWWWWWWWWW
