DEFAULT
7,1

WWWWWWWWWWWWWWWWWWWWWWWWWWWWWWWWWWWWWWWWW
WFFFFFFFFFFFFFFFFFFFFFFFFFFFWFFFFFFFFFFFW
WFFFFFFFFFFFFFFFFFFFFFFFFFFFWFFFFFFFFFFFW
WFWFWFFFFFFFFFFFFWWWWWWWWWWWWFFFFFFFFFFFW
WFFFFFFFFFFFFFFFFFFFFFFFFFFFWFFFFFFFFFFFW
WFFFFFFFFFFFFFFFFFFFFFFFFFFFWFFFFFFFPPPPW
WFWFWFFFFFFFFFFFFFFFFFFFFFFFFFFFFFFFPPPPW
WFFFFFFFFFFFFFFFFFFFFFFFFFFFWFFFFFFFPPPPW
WFFFFFFFFFFFWDWFFFFFFFFFFFFFWFFFFFFFFFFFW
WFFFFFFFFFFFFFFFFFFFFFFFFFFFWFFFFPPPPFFFW
WFFDFFFFFFFFSPFFFFFFFFFFFFFFWFFFFPPPPFFFW
WFWWWWWWWWWWWWWWWWWWWWWWWWWWWFFFFPPPPFFFW
WFWWWWTWWWWWWWWWWWWWWWWWWWWWWWWWWWWWWWWWW
WFFFFFFFFFFFFFFFFFFFFFFFFFFFFFFFFFFFFFFFW
TFFFFFFFFFFFFFFFWFFFFFFFFFFFFFFFFFFFFFFFW
WFFFFFFFFFFFFFFFWFFFFFFFFFFFFFFFFFFFFFFFW
WFFFFFFFFFFFFFFFTFFFFFFFFFFFFFFFFFFFFFFFW
WFFFFFFFFFFFFFFFWFFFFFFFFFFFFFFFFFFFFFFFW
WWWWWWWWWWWTWWWWWWWWWWWWWWWWWWWWWWWWWWWWW

