
7,7

WWWWWWWWWWWWWWWWWW
WFFFWFWFFFFFFFFWFW
WFFFWFFFWWFWWWFWFW
WWWFWFWFWFFFFWFFFW
WFFFFFWFWFFFFWFFFW
WWWWWWWFWWWFFWWWFW
WFFFWFFFFFWFFWFWFW
WWWFFFFFFFWWWWFWFW
WFWFWFFFFFFFFFFWFW
WFWFWFFFFFWWWFWWFW
WFWWWWWFWWWFWFWEFW
WFWFFFFFWFFFWFWWFW
WFWFWWFFWFFWWFFWFW
WFWFWFFFWWFWFFFWFW
WFWFWWWFFWFWWWWWFW
WFFFFFWFFWFFFFFFFW
WWWWWWWWWWWWWWWWWW