
15,14

WWWWWWWWWWWWWWWWWW
WFWFFFFFWFFFFFFFFW
WFWFWWWFWWFFWWWWFW
WFWFFFWFEWWFWFFWFW
WFWFWWWWWWWFWFFFFW
WFWFWFFFWFFFWWWWFW
WFWFWWWFWFWWWFFWFW
WFFFFFWFWFWFFFFWFW
WFWFFWWFFFWWFWFFFW
WFWFFWFFWFFWFWFWFW
WFWWWWWFWWFFFWWWFW
WFFFFFFFFWFFFFWFFW
WFWWWWWWFWWFFWWFWW
WFFFFFFWFFWWWWFFFW
WWWWWWWWFFFFFFFFFW
WFFFFFFFFFFFFWFFFW
WWWWWWWWWWWWWWWWWW