
4,15

WWWWWWWWWWWWWWWWWW
WEWFFFFFFFWWWFFWFW
WFWWFFFFFFFFWWFWFW
WFFFFWWWWWWFFWFFFW
WFFWWWFFFFWWFWWFFW
WFFWFFFFWFFWFFFFFW
WWWWWFWWWFFWFFWWFW
WFFWFFWFFFFWWFFWFW
WFFWFFWFFFFFFFFFFW
WFFFFFWFWWWWWWWWFW
WWWFWFFFFWFFFFFWFW
WFFFWWFFWWFFFWWWFW
WFFFFWWFWFFFWWFWFW
WWFWFFWWWFWWWFFWFW
WFFWFFFWFFFFWFFWFW
WFFWFFFFFFFFFFFWFW
WWWWWWWWWWWWWWWWWW