FOREST
38,26
37,27;37,26;36,26;85,48;4,48;3,35;4,33;5,33;5,34;6,34;61,42;
WWWWWWWWWWWWWWWWWWWWWWWWWWWWWWWWWWWWWWWWWWPPPWWWWWWWWWWWWWWWWWWWWWWWWWWWWWWWWWWWWWWWWWWWWWWWWW
WFFFFFFFFFFFFFFFFFFFFFFFFFFFFFFFFFFFFFFFFFPPPFFFFFFFFFFFFFFFFFFFFFFFFFFFFFFFFFFFFFFFFFFFFFFFFW
WFFFFFFFFFFFFFFFFFFFFFFFFFFFFFFFFFFFFFFFFFPPPFFFFFFFFFFFFFFFFFFFFFFFFFFFFFFFFFFFFFFFFFFFFFFFFW
WFFFFFFFFFFFFFFFFFFFFFFFFFFFFFFFFFFFFFFFFFPPFFFFFFFFFFFFFFFFFFFFFFFFFFFFFFFFFFFFFFFFFFFFFFFFFW
WFFFFFFFFFFFFFFFFFFFFFFFFFFFFFFFFFFFFFFFFFPPFFFFFFFFFFFFFFFFFFFFFFFFFFFFFFFFFFFFFFFFFFFFFFFFFW
WFFFFFFFFFFFFFFFFFFFFFFFFFFFFFFFFFFFFFFFFPPFFFFFFFFFFFFFFFFFFFFFFFFFFFFFFFFFFFFFFFFFFFFFFFFFFW
WFFFFFFFFFFFFFFFFFFFFFFFFFFFFFFFFFFFFFFFPPFFFFFFFFFFFFFFFFFFFFFFFFFFFFFFFFFFFFFFFFFFFFFFFFFFFW
WFFFFFFFFFFFFFFFFFFFFFFFFFFFFFFFFFFFFFPPPFFFFFFFFFFFFFFFFFFFFFFFFFFFFFFFFFFFFFFFFFFFFFFFFFFFFW
WFFFFFFFFFFFFFFFFFFFFFFFFFFFFFFFFFFFFPPFFFFFFFFFFFFFFFFFFFFFFFFFFFFFFFFFFFFFFFFFFFFFFFFFFFFFFW
WFFFFFFFFFFFFFFFFFFFFFFFFFFFFFFFFFFFPPFFFFFFFFFFFFFFFFFFFFFFFFFFFFFFFFFFFFFFFFFFFFFFFFFFFFFFFW
WFFFFFFFFFFFFFFFFFFFFFFFFFFFFFFFFFFFPFFFFFFFFFFFFFFFFFFFFFFFFFFFFFFFFFFFFFFFFFFFFFFFFFFFFFFFFW
WFFFFFFFFFFFFFFFFFFFFFFFFFFFFFFFFFFPPFFFFFFFFFFFFFFFFFFFFFFFFFFFFFFFFFFFFFFFFFFFFFFFFFFFFFFFFW
WFFFFFFFFFFFFFFFFFFFFFFFFFFFFFFFFFFPFFFFFFFFFFFFFFFFFFFFFFFFFFFFFFFFFFFFFFFFFFFFFFFFFFFFFFFFFW
WFFFFFFFFFFFFFFFFFFFFFFFFFFFFFFFFFFPFFFFFFFFFFFFFFFFFFFFFFFFFFFFFFFFFFFFFFFFFFFFFFFFFFFFFFFFFW
WFFFFFFFFFFFFFFFFFFFFFFFFFFFFFFFFFFPFFFFFFFFFFFFFFFFFFFFFFFFFFFFFFFFFFFFFFFFFFFFFFFFFFFFFFFFFW
WFFFFFFFFFFFFFFFFFFFFFFFFFFFFFFFFFFPFFFFFFFFFFFFFFFFFFFFFFFFFFFFFFFFFFFFFFFFFFFFFFFFFFFFFFFFFW
WFFFFFFFFFFFFFFFFFFFFFFFFFFFFFFFFFPPFFFFFFFFFFFFFFFFFFFFFFFFFFFFFFFFFFFFFFFFFFFFFFFFFFFFFFFFFW
WFFFFFFFFFFFWWWWFFFFFFFFFFFFFFFFFFPFPFFFPPFFFFFFFFFFFFFFFFFFFFFFFFFFFFFFFFFFFFFFFFFFFFFFFFFFFW
WFFFFFFFFFFWWWWWFFFFFFFFFFFFFFFFFPPFFFFFFFPPFFFFFFFFFFFFFFFFFFFFFFFFFFFFFFFFFFFFFFFFFFFFFFFFFW
PPFFFFFFFFFWWWWWFFFFFFFFFFFFFFFFPPFFFFFFFFFFPPFFFFFFFFFFFFFFFFFFFFFFFFFFFFFFFFFFFFFFFFFFFFFFFW
PPPFFFFFFFFWWWWWFFFFFFFFFFFFFFFPPFFFFFFFFFFFFPPFFFFFFFFFFFFFFFFFFFFFFFFFFFFFFFFFFFFFFFFFFFFFFW
PPPPFFFFFFFWWWWWFFFFFFFFFFFFFFFPFFWWWFWWWWWWWFPFFFFFFFFFFFFFFFFFFFFFFFFFFFFFFFFFFFFFFFFFFFFFFW
PPPPFFFFFFFWWWWFFFFFFFFFFFFFFFFFFFFFFFFFFFFFWFFPPFFFFFFFFFFFFFFFFFFFFFFFFFFFFFFFFFFFFFFFFFFFFW
PPPPPPFFFFFWWWWFFFFFFFFFFFFFFFFFFFFFFFFFFFFFWFFFPPFFFFFFFFFFFFFFFFFFFFFFFFFFFFFFFFFFFFFFFFFFFW
PPPPPPPFFFFWWWFFFFFFFFFFFFFFFFFPPFWFFFFFFFFFFFFFFFPPFFFFFFFFFFFFFFFFFFFFFFFFFFFFFFFFFFFFFFFFFW
PPPPPPPPFFFWWWFFFFFFFFFFFFFFFFFFPFWFFFFFFFFFWFFFFFFPPPFFFFFFFFFFFFFFFFFFFFFFFFFFFFFFFFFFFFFFFW
PPPPPPPFFFFWWWFFFFFFFFFFFFFFFFFFPFWFFFFFFFFFWFFFFFFFFPPPPFFFFFFFFFFFFFFFFFFFFFFFFFFFFFFFFFFFFW
PPPPPPPFFFFWWWWFFFFFFFFFFFFFFFFFPWWFFFFFFFFFWWFFFFFFFFFPPPFFFFFFFFFFFFFFFFFFFFFFFFFFFFFFFFFFFW
PPPPPFFFFFWWWWWFFFFFFFFFFFFFFFFPPWFFFFFFFFFFFWFFFFFFFFFFPPFFFFFFFFFFFFFFFFFFFFFFFFFFFFFFFFFFFW
PPPPPPFFFFWWWWWFFFFFFFFFFFFFFFFPWWWWWWWFFWWWWWFFFFFFFFFFFPPFFFFFFFFFFFFFFFFFFFFFFFFFFFFFFFFFFW
PPPPPPFFFFWWWWFFFFFFFFFFFFFFFFPPFFFFFFFFFFFFFFFFFFFFFFFFFFPPFFFFFFFFFFFFFFFFFFFFFFFFFFFFFFFFFW
PPPPPFFFFFWWWWFFFFFFFFFFFFFFPPPFFFFFFFFFFFFFFFFFFFFFFFFFFFFPPPFFFFFFFFFFFFFFFFFFFFFFFFFFFFFFFW
PPPPFFFFFWWWWFFFFFFFFFFFFFPPPPFFFFFFFFFFFFFFFFFFFFFFFFFFFFFFPPPFFFFFFFFFFFFFFFFFFFFFFFFFFFFFFW
WFPFFFFFFWWWWFFFFFFFFFFFFPPPPPFFFFFFFFFFFFFFFFFFFFFFFFFFFFFFFFPPFFFFFFFFFFFFFFFFFFFFFFFFFFFFFW
WFFFFFFWWWWWFFFFFFFFFFFPPPPFFFFFFFFFFFFFFFFFFFFFFFFFFFFFFFFFFFPPPFFFFFFFFFFFFFFFFFFFFFFFFFFFFW
WFFFFFWWWWWWFFFFFFFFFFPPPFFFFFFFFFFFFFFFFFFFFFFFFFFFFFFFFFFFFFFPPPFFFFFFFFFFFFFFFFFFFFFFFFFFFW
WFFFWWWWWWWWWFFFFFFFFPPPFFFFFFFFFFFFFFFFFFFFFFFFFFFFFFFFFFFFFFFFFPFFFFFFFFFFFFFFFFFFFFFFFFFFFW
WWWWWWWWWWWWFFFFFFFFFPPFFFFFFFFFFFFFFFFFFFFFFFFFFFFFFFFFFFFFFFFFFPPFFFFFFFFFFFFFFFFFFFFFFFFFFW
WWWWWWWWWWWFFFFFFFFFFPPFFFFFFFFFFFFFFFFFFFFFFFFFFFFFFFFFFFFFFFFFFFPPFFFFFFFFFFFFFFFFFFFFFFFFFW
WWWWWWWWWWFFFFFFFFFFPPFFFFFFFFFFFFFFFFFFFFFFFFFFFFFFFFFFFFFFFFFFFFFPPFFFFFFFFFFFFFWWWFFWWWWWWW
WWWWWWWWWWFFFFFFFFFFPFFFFFFFFFFFFFFFFFFFFFFFFFFFFFFFFFFFFFFFFFFFFFFPPPFFFFFFFFFFWWFFFFFFFFWFFW
WWWWWWWWWFFFFFFFFFFPPFFFFFFFFFFFFFFFFFFFFFFFFFFFFFFFFFFFFFFFFFFFFFFFPPPPFFFFFFFFWFFFFFFFFWWFFW
WWWWWWWWWFFFFFFFFFFPPFFFFFFFFFFFFFFFFFFFFFFFFFFFFFFFFFFFFFFFFFFFFFFFPPPPPFFFFFFWFWFFFFFFWWFFFW
WWWWWWWWWWFFFFFFFFFPFFFFFFFFFFFFFFFFFFFFFFFFFFFFFFFFFFFFFFFFFFFFFFFFFPPPPPFFFFWFFWWWFFFWWFFFFW
WWWWWWWWWWFFFFFFFFFPFFFFFFFFFFFFFFFFFFFFFFFFFFFFFFFFFFFFFFFFFFFFFFFFFFPPPPPPWWWFFFFWFFWWFFFFFW
WWWWWWWWWWFFFFFFFFPPFFFFFFFFFFFFFFFFFFFFFFFFFFFFFFFFFFFFFFFFFFFFFFFFFFFFPWWWWFWFFFFWFFFFFFFFFW
WWWWWWWWWWFFFFFFFFPPFFFFFFFFFFFFFFFFFFFFFFFFFFFFFFFFFFFFFFFFFFFFFFFFFFFFFWFFFFWWWFFWFFFFFFFFFW
WWWWFFFWWWWFFFFFFFPFFFFFFFFFFFFFFFFFFFFFFFFFFFFFFFFFFFFFFFFFFFFFFFFFFFFFFWFFFFFFWFFWFFFFFFFFFW
WWWFFFFWWWWFFFFFFPPFFFFFFFFFFFFFFFFFFFFFFFFFFFFFFFFFFFFFFFFFFFFFFFFFFFFFFWFFFFFFWFFWFFFFFFWWFW
WWWFFFFWWWFFFFFFFPPFFFFFFFFFFFFFFFFFFFFFFFFFFFFFFFFFFFFFFFFFFFFFFFFFFFFFFWFFFFFFFWFFFFFFFFWFFW
WWWFFFFFWWWFFFFFFPFFFFFFFFFFFFFFFFFFFFFFFFFFFFFFFFFFFFFFFFFFFFFFFFFFFFFFFWFWFWWWFFFFFFFFWWWFFW
WWWWFFFFFFFFFFFFFPFFFFFFFFFFFFFFFFFFFFFFFFFFFFFFFFFFFFFFFFFFFFFFFFFFFFFFWFFWFWFWWFFFFFFWWFFFFW
WWWWWWWWFFFFFFFFFPFFFFFFFFFFFFFFFFFFFFFFFFFFFFFFFFFFFFFFFFFFFFFFFFFFFFFFWFFWWWFFFWFFFFFWWFFFFW
WWWWWWWFFFFFFFFFFPFFFFFFFFFFFFFFFFFFFFFFFFFFFFFFFFFFFFFFFFFFFFFFFFFFFFFFWFFFFFFFFWFFFFFFWFFFFW
WWWWWWWWWWWWWWWWWWWWWWWWWWWWWWWWWWWWWWWWWWWWWWWWWWWWWWWWWWWWWWWWWWWWWWWWWWWWWWWWWWWWWWWWWWWWWW


