DEFAULT
12.282465,4.3940716
12,1;6,4;2,1;1,4;
WWEWWWWWWSWWWW
WFFFFFFFWSWFFW
WFFWWWWFWSWFFW
WFFWWWWFWWWFFW
WFFFFFFFFFFFFW
WFFWWWWWWWWFFW
WWWWSSSSSSWWWW

