DEFAULT
1.6756061,9.324475
9,9;3,9;1,4;11,4;13,4;
WWWWWWWWWWWWWWW
WFFFWFFFFFFFWFW
WFFFWFFFFFFFWFW
WFFFFFFFFFFFWFW
WFFFFFFFFFFFWFW
WFFWFFWFFFFFWFW
WFFWFFWFFFFFWFW
WFFWFFWFFFFFFFW
WWWWFFWWWWWFFEW
WFFFFFFFFFWFFFW
WWWWWWWWWWWWWWW
