DEFAULT
6.5239806,5.192255

WWWWWWWWWWWW
WFFFFFFFFFHW
WFFFFFFFFFHW
WFFWFFFFFFFW
WFFWFFFWWWWW
WFFWWWWWFEHW
WFFFFFFWFFFW
WFFFFFFWFFFW
WHFFFFFFFFFW
WWWWWWWWWWWW
