DEFAULT
1.7359625,1.3166015
7,1;13,4;10,2;
WWWWWWWWWWWWWWWWWSSS
WFFFFFFFWFFFFFFFWSSS
WFFFFFFFWFFFFFFFWWWW
WFFFFFFFDFFFFFFFDFFE
WFFFFFFFWFFFFFFFWWWW
WFFFFFFFWFFFFFFFWSSS
WWWWWWWWWWWWWWWWWSSS
