TEMPLE
23.676682,6.8290606

WWWWWWWWWWWWWWWWWWWWWWWWWWWW
WFFWFFFFFFFFFFFFWFFFFFWFFFFW
WFFWWFFFFFFFFFFFWFFFFFWFFFFW
WFFFWFFFFFWFFFFFFFFFFFWFFFFW
WFFFWFFFFFWWWWFFFFFWFFWFFFFW
WFPFWWWWFFWFFFPWWWFWFFFFFFFW
WFFFFFPWFFWFFFWWFFPWFFFFFFFW
DFFFFFFWFFFFPFWFFFFWFFFFFFFE
WFFFPFFWFFFFFFFFFWFWWWWWWFFW
WFFFFFFFFWWWFFFFFWFFFFFFWFFW
WPFFFFFFFFFFFWFFWWFPFFFFWFFW
WFFWWWWFFFWFFWFFFWWFFWFFWWWW
WFFFFPFFFFWFFWFFFFFFFWFFFPPW
WFFFFFFFPFFFFWFFFFFFFWFFFPPW
WWWWWWWWWWWWWWWWWWWWWWWWWWWW
