FOREST
1.5,6.5

SSSSSSSSSSSWWWSSWWWSSWWWSSWWWS
SSSSSSSSSSSWDWSSWDWSSWEWSSWDWS
SSSSSSSSSSSWFWSSWFWSSWFWSSWFWS
SSSSSSSSSSSWFWSSWFWSSWFWSSWFWS
SSSSSSSSSSSWFWSSWFWSSWFWSSWFWS
WWWWWWWSSSSWFWSSWFWSSWFWSSWFWS
WFWFFFWWWWWWFWWWWFWWWWFWWWWFWW
WFWFWFWFFFFFFFFFFFFFFFFFFFFFFW
WFWFWFWFWWWWWWWWWWWWWWWWWWWWWW
WFWFWFWFWSSSSSSSSSSSSSSSSSSSSS
WFWFWFWFWSSSSSSSSSSSSSSSSSSSSS
WFFFWFFFWSSSSSSSSSSSSSSSSSSSSS
WWWWWWWWWSSSSSSSSSSSSSSSSSSSSS
