DEFAULT
5,1

WWWWWWWWWWWWWWWWWWW
WFFFFFFFFFFFFFFFWFW
WFFFFFFFFFFWFFFWWWW
WWFFFWFFFFWWWWWFFFW
WFFFFWFFFFWFWFWFFWW
WFWWWWWWWFWWWWWFFFW
WFFFWWWFFFWFFFWFWWW
WFWWWWWWWFWWWWWFFFW
WFFFFWFFFFWWWWWFFFW
WFFFFWFFFFWFFFWFFFW
WFFFFFFFFFWWWWWFWWW
WEFFFFFFFFFFFFFFFFW
WWWWWWWWWWWWWWWWWWW
