DEFAULT
7,1

WWWWWWWWW
WFWFWFFFW
WFFFWFWWW
WWWFWFFFW
WEWFWWWWW
WFWFWFFFW
WWWWWWWWW
