DEFAULT
25,22

WWWWWWWWWWWWWWWWWWWWWWWWWWWWWWWWWWWWWWWWWWWWWWWWWWWWWWWWWWW
WWWWWWWWWWWWWWWWWWWWWWWWWWWWWWWWWFFFFFFWWWWWWWWWWWWWWWWWWWW
WWWWWWWWWWWWWWWWWWWWWWWWWWWWWWWWWFFFFFFWWWWWWWWWWWWWWWWWWWW
WWWWWWWWWWWWWWWWWWWWWWWWWWWWWWWWWFFFFFFWWWWWWWWWWWWWWWWWWWW
WWWWWWWWWWWWWWWWWWWWWWWWWWWWWWWWWFFFFFFWWWWWWWWWWWWWWWWWWWW
WWWWWWWWWWWWWWWWWWWWWWWFWWWWWWWWWFFFFFFWWWWWWWWWWWWWWWWWWWW
WWWWWWWWWWWWWWWWWWWWFFFFWWWWWWWWWFFFFFFWWWWWWWWWWWWWWWWWWWW
WWWWWWWWWWWWWWWWWWWWFFFFWWFFFFFFDFFFFFFWWWWWWWWWWWWWWWWWWWW
WWWWWWWWWWWWWWWWWWWWFFFFWWFFFFFFWWWWWWWWWWWWWWWWWWWWWWWWWWW
WWWWWWWWWWWFFFFFFFWWFFFFWWFFFFFFWWWWWWWWWWWWWWWWWWWWWWWWWWW
WWWWWWWWWFFFFFFFFFDFFFFFFWFFFFFFWWWWWWWWWWWWWWWWWWWWWWWWWWW
WWWWWWWWWFWWWWWWWWWWWWWWWWFFFFFFWWWWWWWWWWWWWWWWWWWWWWWWWWW
WWWWWWWWWFWFFFFFWWWWWWWWWWFFFFFFWWWWWWWWWWWWWWWWWWWWWWWWWWW
WWWWWWWWWFWFFFFFWWWWWWWWWWDWWWWDWWWWWWWWWWWWWWWWWWWWWWWWWWW
WWWWWFFFFFWFFFFFWWWFFFFFFWFFWWWFWWWWWWWWWWWWWWWWWWWWWWWWWWW
WWWWWDWWWWWFFFFFWWWFFFFFFDFFWWWFWWWWWWWWWWWWWWWWWWWWWWWWWWW
WWFFFFWFFFFFFFFFWWWFFFFFFWFFWWWFWWWWWWWWWWWWWWWWWWWWWWWWWWW
WWFFFFDFWWWWWWWWWWWFFFFFFWFFFFFFWWWWWWWWWWWWWWWWWWWWWWWWWWW
WWFFFFWWWWWFFFFFFFWWWWWWWWDWWWWWWWWWWWWWWWWWWWWWWWWWWWWWWWW
WWFFFFWWWWWFFFFFFFWWWWWWFFFWFFWWWWWWWWWWWWWWWWWWWWWWWWWWWWW
WWFFFFWWWWWFFFFFFFWWWWWWFFFWFFWWWWWWWWWWWWWWWWWWWWWWWWWWWWW
WWFFFWWWWWWFFFFFFFWWWWWWWFFWFFWWWWWWWWWWWWWWWWWWWWWWWWWWWWW
WWFFFWWWWWWFFFFFFFWWWWWWFFFFFFWWWWWWWWWWWWWWWWWWWWWWWWWWWWW
WFFFFWWWWWWFFFFFFFDFFFFDFFFFFFWWWWWWWWWWWWWWWWWWWWWWWWWWWWW
WFFFFWWWWWWWFFFFFFWFWWWWWWWWWWWWWWWWWWWWWWWWWWWWWWWWWWWWWWW
WFFFFWFFFFFWFFFFFFWFWWWWWWWWWWWWWWWWWWWWWWWWWWWWWWWWWWWWWWW
WFFFFDFWWWFWFFFFFFDFWWWWWWWWWWWWWWWWWWWWWWWWWWWWWWWWWWWWWWW
WFFFFWWWWWFDFFFFFFWWWWWWWWWWWWWWWWWWWWWWWWWWWWWWWWWWWWWWWWW
WFFFFWWWWWWWFFFFFFWWWWWWWWWWWWWWWWWWWWWWWWWWWWWWWWWWWWWWWWW
WWWWWWWWWWWWWWWWWWWWWWWWWWWWWWWWWWWWWWWWWWWWWWWWWWWWWWWWWWW
WWWWWWWWWWWWWWWWWWWWWWWWWWWWWWWWWWWWWWWWWWWWWWWWWWWWWWWWWWW
WFFFFFFFFFFFFFFFFFFFFFFFWFWFFFFFFFFFFFFFFFFFFFFFFFFFFFFFFFW
WFFFFFFFFFFFFFFFFFFWFFFWWWWFFFWWWFFWWWFFWWFWWFFFFFFWFFFFFFW
WFFFFWFWFFFFFWWWFFWWWWWFFFWFFFWWWWWWWWFFWWFWWFFFFFFWFFFFFFW
WFFFFWFWFFFFFWWWFFWWWWWFFFWFFFWWWWWWWWFFWFFFWFFFFFWWWFFFFFW
WFWWWWWWWWFFFWFWFFWFFFWFWWWFFFWWWFFWWWFFWFFFWFFFFWWWWWFFFFW
WFFFFWWWWWFFFWFWFFWWWWWFFFWFFFFFFFFFFFFFWWFWWFWWWWWWWWWWWFW
WFWWWWWWWWWWWFFFFFWWWWWFFFWFFFWWFFWWFFFFWWFWWFFFFWWWWWFFFFW
WFFFFWWWWWFFFFFFFFWFFFWFFFWFFFWWWWWWFFFFWWFWWFFFFFWWWFFFFFW
WFFFFWWWWWWWWFFFFFWWWWWFWWWFFFFFFFFFFFFFFFFFFFFFFFFWFFFFFFW
WFFFFFFWFWFFFFFFFFFFFFFFFFFFFFWWWWWWFFFFWWFWWFFFFFFWFFFFFFW
WFFFFFFWFWFFFFWWWWWWWWWWFFFFFFWWFFWWFFFFWWFWWFFFFFFFFFFFFFW
WFFFFFFWFWFFFFWWWWWWWWWWFFFFFFFFFFFFFFFFWFFFWFFFFFFFFFFFFFW
WFFFFFFFFFFFFFWWFFWWFFWWFFFFFFWFFFFFFFFFWFFFWFFWFFFFFFFFFFW
WFFFFFFFFFFFFFWWFFWWFFWWFFFWFFWFFWFFFFFFWWFWWFFWFFFFFFFFFFW
WFFFFFFFFFFFFFWWWWWWWWWWFFFWFFWFFWFFFFFFWWFWWFFWFFFFFFFFFFW
WEFFFFWWFFFFFFWWWWWWWWWWFFFWFWWWFWFFFFFFFFFFFFWWWFFFFFFFFFW
WFFFFWWWWFFFFFWWFFWWFFWWFFFWWWWWWWFFFFWWWWWWWWWWWWFFFFFFFFW
WFFFFWWWWFFFFFWWFFWWFFWWFWWWWWWWWWWWFFFFFFWWWWWWWWWWWFFFFFW
WFFFFFWWFFFFFFWWWWWWWWWWFFFFWWWWWWWWWWWWFFFFWWWWWWWFFFFFFFW
WFFFFFFFFFFFFFWWWWWWWWWWFFFFFWWWFFFFFFFFFFFFWFWWWFWFFFFFFFW
WFFFFFFFFFFFFFFFFFFFFFFFFFFFFFWFFFFFFFFFFFFFWFFWFFWFFFFFFFW
WFFFFFFFFFFFFFFFFFFFFFFFFFFFFFWFFFFFFFFFFFFFWFFWFFWFFFFFFFW
WFFFFFFFFFFWFFFFFFFFFFFFFFFFFFWFFFFFFFFFFFFFFFFWFFFFFFFFFFW
WFFFFFFFFFWWWFFFFFFFFFFFFFFFFFFFFFFFFFFFFFFFFFFFFFFFFFFFFFW
WFFFFFFFFWWWWWFFFFFFFFFFFFFFFFWFWWWWWWWWWWWFWWWWFWWWWFFFFFW
WFFFFFFFWWWWWWWFFFFFFFFFFFFFFFWFWFFFFFFFFFWFWFFWFWFFWFFFFFW
WFFFFFFFFWWWWWFFFFFFFFFFFFFFFFWFWFWWWWWFFFWFWFWWFWWFWFFFFFW
WFFFFFFFFFWWWFFFFFFFFFFFFFFFFFWWWFWFFFWFFFWFWFWFFFWFWFFFFFW
WFFFFFFFFFFWFFFFFFFFFFFFFFFFFFFFFFWFFFWWWWWFWFWWWWWFWFFFFFW
WFFFFFFFFFFFFFFFFFFFFFFFFFFFFFWWWWWFFFFFFFFFWFFFFFFFWFFFFFW
WFFFFFFFFFFFFFFFFFFFFFFFFFFFFFWFFFFFWWWWWWFWWFFFWWWWWFFFFFW
WFFFFFFFFFFFFFFFFFFFFFFFFFFFFFWWWWWWWFFFFWWWFFFFWFFFFFFFFFW
WFFFFFFFFFFFFFFFFFFFFFFFFFFFFFFFFFFFFFFFFFFFFFFFFFFFFFFFFFW
WWWWWWWWWWWWWWWWWWWWWWWWWWWWWWWWWWWWWWWWWWWWWWWWWWWWWWWWWWW
