DEFAULT
1,20

WWWWWWWWWWWWWWWWWWWWWWWWWWWWWWWWWWWWWWWWWWWWWWWWWWWWWWWWWWW
WFFFFFFFFFFFFFFFFFFFFFFFWFWFFFFFFFFFFFFFFFFFFFFFFFFFFFFFFFW
WFFFFFFFFFFFFFFFFFFFFFFWWWWFFFWWWFFWWWFFWWFWWFFFFFFWFFFFFFW
WFFFFWFWFFFFFWWWFFWWWWWFFFWFFFWWWWWWWWFFWWFWWFFFFFFWFFFFFFW
WFFFFWFWFFFFFWWWFFWWWWWFFFWFFFWWWWWWWWFFWFFFWFFFFFWWWFFFFFW
WFWWWWWWWWFFFWFWFFWFFFWFWWWFFFWWWFFWWWFFWFFFWFFFFWWWWWFFFFW
WFFFFWWWWWFFFWFWFFWWWWWFFFWFFFFFFFFFFFFFWWFWWFWWWWWWWWWWWFW
WFWWWWWWWWWWWFFFFFWWWWWFFFWFFFWWFFWWFFFFWWFWWFFFFWWWWWFFFFW
WFFFFWWWWWFFFFFFFFWFFFWFFFWFFFWWWWWWFFFFWWFWWFFFFFWWWFFFFFW
WFFFFWWWWWWWWFFFFFWWWWWFWWWFFFFFFFFFFFFFFFFFFFFFFFFWFFFFFFW
WFFFFFFWFWFFFFFFFFFFFFFFFFFFFFWWWWWWFFFFWWFWWFFFFFFWFFFFFFW
WFFFFFFWFWFFFFWWWWWWWWWWFFFFFFWWFFWWFFFFWWFWWFFFFFFFFFFFFFW
WFFFFFFWFWFFFFWWWWWWWWWWFFFFFFFFFFFFFFFFWFFFWFFFFFFFFFFFFFW
WFFFFFFFFFFFFFWWFFWWFFWWFFFFFFWFFFFFFFFFWFFFWFFWFFFFFFFFFFW
WFFFFFFFFFFFFFWWFFWWFFWWFFFWFFWFFWFFFFFFWWFWWFFWFFFFFFFFFFW
WFFFFFFFFFFFFFWWWWWWWWWWFFFWFFWFFWFFFFFFWWFWWFFWFFFFFFFFFFW
WFEFFFWWFFFFFFWWWWWWWWWWFFFWFWWWFWFFFFFFFFFFFFWWWFFFFFFFFFW
WFFFFWWWWFFFFFWWFFWWFFWWFFFWWWWWWWFFFFWWWWWWWWWWWWFFFFFFFFW
WFFFFWWWWFFFFFWWFFWWFFWWFWWWWWWWWWWWFFFFFFWWWWWWWWWWWFFFFFW
WFFFFFWWFFFFFFWWWWWWWWWWFFFFWWWWWWWWWWWWFFFFWWWWWWWFFFFFFFW
WFFFFFFFFFFFFFWWWWWWWWWWFFFFFWWWFFFFFFFFFFFFWFWWWFWFFFFFFFW
WFFFFFFFFFFWFFFFFFFFFFFFFFFFFFWFFFFFFFFFFFFFWFFWFFWFFFFFFFW
WFFFFFFFFFFWFFFFFFFFFFFFFFFFFFWFFFFFFFFFFFFFWFFWFFWFFFFFFFW
WFFFFFFFFFFWFFFFFFFFFFFFFFFFFFWFFFFFFFFFFFFFFFFWFFFFFFFFFFW
WFFFFFFFFFWWWFFFFFFFFFFFFFFFFFFFFFFFFFFFFFFFFFFFFFFFFFFFFFW
WFFFFFFFFWWWWWFFFFFFFFFFFFFFFFWFWWWWWWWWWWWFWWWWFWWWWFFFFFW
WFFFFFFWWWWWWWWWFFFFFFFFFFFFFFWFWFFFFFFFFFWFWFFWFWFFWFFFFFW
WFFFFFFFFWWWWWFFFFFFFFFFFFFFFFWFWFWWWWWFFFWFWFWWFWWFWFFFFFW
WFFFFFFFFFWWWFFFFFFFFFFFFFFFFFWWWFWFFFWFFFWFWFWFFFWFWFFFFFW
WFFFFFFFFFFWFFFFFFFFFFFFFFFFFFFFFFWFFFWWWWWFWFWWWWWFWFFFFFW
WFFFFFFFFFFWFFFFFFFFFFFFFFFFFFWWWWWFFFFFFFFFWFFFFFFFWFFFFFW
WFFFFFFFFFFWFFFFFFFFFFFFFFFFFFWFFFFFWWWWWWFWWFFFWWWWWFFFFFW
WFFFFFFFFFFFFFFFFFFFFFFFFFFFFFWWWWWWWFFFFWWWFFFFWFFFFFFFFFW
WFFFFFFFFFFFFFFFFFFFFFFFFFFFFFFFFFFFFFFFFFFFFFFFFFFFFFFFFFW
WWWWWWWWWWWWWWWWWWWWWWWWWWWWWWWWWWWWWWWWWWWWWWWWWWWWWWWWWWW
