DEFAULT
5,1

WWWWWWWWWWWWWWWWWWW
WFFFFFFFFFFFFFFFWFW
WFWWWWWWFFFWFFFWWWW
WFFFWWFFFFWWWWWFFFW
WFFFWWFFFFWFWFWFFWW
WFWWWWWWFFWWWWWFFFW
WFFFFFFFFFWFFFWFWWW
WFWWWWWWFFWWWWWFFFW
WFWWWWWWFFWWWWWFFFW
WFFFFFFFFFWFFFWFFFW
WFFFFFFFFFWWWWWFWWW
WEFFFFFFFFFFFFFFFFW
WWWWWWWWWWWWWWWWWWW
