DEFAULT
7,1
3,3;
WWWWWWWWW
WFFFFFFFW
WFFFFFFFW
WFFFFFFFW
WFFFFFFFW
WEFFFFFFW
WWWWWWWWW
