DEFAULT
5,1

WWWWWWWWWWWWWWWWWWWWWWWWWWW
WFFFFFFFFFFFFFFFFFFFFFFFWFW
WFFFFFFFFFFFFFFFFFFWFFFWWWW
WFFFFWFWFFFFFWWWFFWWWWWFFFW
WFFFFWFWFFFFFWWWFFWFWFWFFWW
WFFFFWFWFFFFFWWWFFWWWWWFFFW
WFWWWWWWWWFFFWFWFFWFFFWFWWW
WFFFFWWWWWFFFWFWFFWWWWWFFFW
WFWWWWWWWWWWWFFFFFWWWWWFFFW
WFFFFWWWWWFFFFFFFFWFFFWFFFW
WFFFFWWWWWWWWFFWWFWWWWWFWWW
WFFFFFFWFWFFFFFWWFFFFFFFFFW
WFFFFFFWFWFFFFFWWFFFFFFFFFW
WFFFFFFWFWFWWWWWWWWWWFFFFFW
WFFFFFFFFFFWWWWWWWWWWFFFFFW
WEFFFFFFFFFFFFFFFFFFFFFFFFW
WWWWWWWWWWWWWWWWWWWWWWWWWWW
