DEFAULT
5,1

WWWWWWWWWWWWWWWWWWW
WFFFFFFWFFFFFFFFWFW
WFFFFWWWFFFFFFFFWFW
WFFFFDFFFFWWWWWFFFW
WWWWWWFWWFWPWPWFFFW
WFFWFWFWWFWWWWWFFFW
WFFWFWFFFFWPWPWFFFW
WWWWDWFFFFWWWWWFFFW
WFFFFFFFFFFFFFFFFFW
WWWFFFFFFWWWWFWWWFW
WFFFFWWFFWWFWWWFWWW
WEFFFFWFFFFFFFWFFFW
WWWWWWWWWWWWWWWWWWW
