DEFAULT
5,1

WWWWWWWWWWWWWWWWWWW
WFFFFFFWFFFFFFFFWFW
WFFFFWWWFFFWFFFWWWW
WWFFFDFFFFWWWWWFFFW
WWWWWWWWFFWFWFWFFWW
WFWWFWWWFFWWWWWFFFW
WFWWFWWWFFWFFFWFWWW
WWWWDWWWFFWWWWWFFFW
WFFFFFFFFFWWWWWFFFW
WWWFFFFFFFWFFFWFFFW
WFFFFWWFFFWWWWWFWWW
WEFFFFWFFFFFFFFFFFW
WWWWWWWWWWWWWWWWWWW
