DEFAULT
7,1

WWWWWWWWW
WFWFFFFFW
WFWWWFFFW
WFFFWFWWW
WWWFWFWFW
WEWWWWWWW
WFWFWFFFW
WFWFWFWFW
WWWWWWWWW
