DEFAULT
5,1

WWWWWWWWWWWWWWWWWWW
WFFFFFFWFFFFFFFFWFW
WFFFFWWWFFFWFFFWWWW
WWFFFFFFFFWWWWWFFFW
WFFWWWWWFFWFWFWFFWW
WFFWWWWWFFWWWWWFFFW
WFFWWWWWFFWFFFWFWWW
WFFFFFFFFFWWWWWFFFW
WFFFFFFFFFWWWWWFFFW
WWWFFFFFFFWFFFWFFFW
WFFFFFFFFFWWWWWFWWW
WEFFFFFFFFFFFFFFFFW
WWWWWWWWWWWWWWWWWWW
