DEFAULT
5,1

WWWWWWWWWWWWWWWWWWWWWWWWWWW
WFFFFFFFFFFFFFFFFFFFFFFFWFW
WFFFFFFFFFFFFFFFFFFWFFFWWWW
WFFFFWFWFFFFFWWWFFWWWWWFFFW
WFFFFWFWFFFFFWWWFFWFWFWFFWW
WFFFFWFWFFFFFWWWFFWWWWWFFFW
WFWWWWWWWWFFFWFWFFWFFFWFWWW
WFFFFWWWWWFFFWFWFFWWWWWFFFW
WFWWWWWWWWWWWFFFFFWWWWWFFFW
WFFFFWWWWWFFFFFFFFWFFFWFFFW
WFFFFWWWWWWWWFFFFFWWWWWFWWW
WFFFFFFWFWFFFFFFFFFFFFFFFFW
WFFFFFFWFWFFFFWWWWFFFFFFFFW
WFFFFFFWFWFWWWWFFWWWWFFFFFW
WFFFFFFFFFFWWWWFFWWWWFFFFFW
WEFFFFFFFFFFFFFFFFFFFFFFFFW
WWWWWWWWWWWWWWWWWWWWWWWWWWW
