DEFAULT
15,10

WWWWWWWWWWWWWWWWWWWWWWWWWWWWWWWWWWWWWWWWWWWWWWWWWWWWWWWWWW
WFFFFFFFFFFFFFFFFFFFFFFFWFWFFFFFFFFFFFFFFFFFFFFFFFFFFFFFFW
WFFFFFFFFFFFFFFFFFFWFFFWWWWFFFWWWFFWWWFFWWFWWFFFFFFFFFFFFW
WFFFFWFWFFFFFWWWFFWWWWWFFFWFFFWWWWWWWWFFWWFWWFFFFFFFFFFFFW
WFFFFWFWFFFFFWWWFFWFWFWFFWWFFFFFFFFFFFFFWWFWWFFFFFFFFFFFFW
WFFFFWFWFFFFFWWWFFWWWWWFFFWFFFWWWWWWWWFFWFFFWFFFFFFFFFFFFW
WFWWWWWWWWFFFWFWFFWFFFWFWWWFFFWWWFFWWWFFWFFFWFFFFFFFFFFFFW
WFFFFWWWWWFFFWFWFFWWWWWFFFWFFFFFFFFFFFFFWWFWWFFFFFFFFFFFFW
WFWWWWWWWWWWWFFFFFWWWWWFFFWFFFWWFFWWFFFFWWFWWFFFFFFFFFFFFW
WFFFFWWWWWFFFFFFFFWFFFWFFFWFFFWWWWWWFFFFWWFWWFFFFFFFFFFFFW
WFFFFWWWWWWWWFFFFFWWWWWFWWWFFFFFFFFFFFFFFFFFFFFFFFFFFFFFFW
WFFFFFFWFWFFFFFFFFFFFFFFFFFFFFWWWWWWFFFFWWFWWFFFFFFFFFFFFW
WFFFFFFWFWFFFFWWWWWWWWWWFFFFFFWWFFWWFFFFWWFWWFFFFFFFFFFFFW
WFFFFFFWFWFFFFWWWWWWWWWWFFFFFFFFFFFFFFFFWFFFWFFFFFFFFFFFFW
WFFFFFFFFFFFFFWWFFWWFFWWFFFFFFFFFFFFFFFFWFFFWFFFFFFFFFFFFW
WFFFFFFFFFFFFFWWFFWWFFWWFFFFFFFFFFFFFFFFWWFWWFFFFFFFFFFFFW
WFFFFFFFFFFFFFWWWWWWWWWWFFFFFFFFFFFFFFFFWWFWWFFFFFFFFFFFFW
WEFFFFWWFFFFFFWWWWWWWWWWFFFFFFFFFFFFFFFFFFFFFFFFFFFFFFFFFW
WFFFFWWWWFFFFFWWFFWWFFWWFFFFFFFFFFFFFFFFFFFFFFFFFFFFFFFFFW
WFFFFWWWWFFFFFWWFFWWFFWWFFFFFFFFFFFFFFFFFFFFFFFFFFFFFFFFFW
WFFFFFWWFFFFFFWWWWWWWWWWFFFFFFFFFFFFFFFFFFFFFFFFFFFFFFFFFW
WFFFFFFFFFFFFFWWWWWWWWWWFFFFFFFFFFFFFFFFFFFFFFFFFFFFFFFFFW
WFFFFFFFFFFFFFFFFFFFFFFFFFFFFFFFFFFFFFFFFFFFFFFFFFFFFFFFFW
WFFFFFFFFFFFFFFFFFFFFFFFFFFFFFFFFFFFFFFFFFFFFFFFFFFFFFFFFW
WWWWWWWWWWWWWWWWWWWWWWWWWWWWWWWWWWWWWWWWWWWWWWWWWWWWWWWWWW
