DEFAULT
4,4
4,2;4,6;2,4;6,4;
WWWWWWWWWWWWWWWWWWWWWWW
WFFFFFFFFFFFFFFFFFFFFFW
WFFFFFFFFFFFFFFFFFFFFFW
WFFFFFFFFFFFFFFFFFFFFFW
WFFFFFFFFFFFFFFFFFFFFFW
WFFFFFFFFFFFFFFFFFFFFFW
WFFFFFFFFFFFFFFFFFFFFFW
WFFFFFFFFFFFFFFFFFFFFFW
WFFFFFFFFFFFFWFFWFFFFFW
WFFFFFFFFFFFFWFFWWWFFFW
WFFFFFFFFFFWWWFFFFWFFFW
WFFFFFFFFFFFFWFFFFWFFFW
WFFFFFFFFFFFFFFFFFFFFEW
WWWWWWWWWWWWWWWWWWWWWWW
