DEFAULT
15,10

WWWWWWWWWWWWWWWWWWWWWWWWWWWWWWWWWWWWWWWWWWWWWWWWWWWWWWWWWW
WFFFFFFFFFFFFFFFFFFFFFFFWFWFFFFFFFFFFFFFFFFFFFFFFFFFFFFFFW
WFFFFFFFFFFFFFFFFFFWFFFWWWWFFFWWWFFWWWFFWWFWWFFFFFFFFFFFFW
WFFFFWFWFFFFFWWWFFWWWWWFFFWFFFWWWWWWWWFFWWFWWFFFFFFFFFFFFW
WFFFFWFWFFFFFWWWFFWFWFWFFWWFFFFFFFFFFFFFWWFWWFFFFFFFFFFFFW
WFFFFWFWFFFFFWWWFFWWWWWFFFWFFFWWWWWWWWFFWFFFWFFFFFFFFFFFFW
WFWWWWWWWWFFFWFWFFWFFFWFWWWFFFWWWFFWWWFFWFFFWFFFFFFFFFFFFW
WFFFFWWWWWFFFWFWFFWWWWWFFFWFFFFFFFFFFFFFWWFWWFFFFFFFFFFFFW
WFWWWWWWWWWWWFFFFFWWWWWFFFWFFFWWFFWWFFFFWWFWWFFFFFFFFFFFFW
WFFFFWWWWWFFFFFFFFWFFFWFFFWFFFWWWWWWFFFFWWFWWFFFFFFFFFFFFW
WFFFFWWWWWWWWFFFFFWWWWWFWWWFFFFFFFFFFFFFFFFFFFFFFFFFFFFFFW
WFFFFFFWFWFFFFFFFFFFFFFFFFFFFFWWWWWWFFFFWWFWWFFFFFFFFFFFFW
WFFFFFFWFWFFFFWWWWWWWWWWFFFFFFWWFFWWFFFFWWFWWFFFFFFFFFFFFW
WFFFFFFWFWFFFFWWWWWWWWWWFFFFFFFFFFFFFFFFWFFFWFFFFFFFFFFFFW
WFFFFFFFFFFFFFWWFFWWFFWWFFFFFFWFFFFFFFFFWFFFWFFFFFFFFFFFFW
WFFFFFFFFFFFFFWWFFWWFFWWFFFFFFWFFFFFFFFFWWFWWFFFFFFFFFFFFW
WFFFFFFFFFFFFFWWWWWWWWWWFFFFFFWFFFFFFFFFWWFWWFFFFFFFFFFFFW
WEFFFFWWFFFFFFWWWWWWWWWWFFFFFWWWFFFFFFFFFFFFFFFFFFFFFFFFFW
WFFFFWWWWFFFFFWWFFWWFFWWFFFFWWWWWFFFFFFFFFFFFFFFFFFFFFFFFW
WFFFFWWWWFFFFFWWFFWWFFWWFWWWWWWWWWWWFFFFFFFFFFFFFFFFFFFFFW
WFFFFFWWFFFFFFWWWWWWWWWWFFFFWWWWWFFFFFFFFFFFFFFFFFFFFFFFFW
WFFFFFFFFFFFFFWWWWWWWWWWFFFFFWWWFFFFFFFFFFFFFFFFFFFFFFFFFW
WFFFFFFFFFFFFFFFFFFFFFFFFFFFFFWFFFFFFFFFFFFFFFFFFFFFFFFFFW
WFFFFFFFFFFFFFFFFFFFFFFFFFFFFFWFFFFFFFFFFFFFFFFFFFFFFFFFFW
WFFFFFFFFFFFFFFFFFFFFFFFFFFFFFWFFFFFFFFFFFFFFFFFFFFFFFFFFW
WFFFFFFFFFFFFFFFFFFFFFFFFFFFFFFFFFFFFFFFFFFFFFFFFFFFFFFFFW
WWWWWWWWWWWWWWWWWWWWWWWWWWWWWWWWWWWWWWWWWWWWWWWWWWWWWWWWWW
