DEFAULT
7,1

WWWWWWWWW
WFWFWFFFW
WFFFWFWWW
WWWFFFFFW
WEWFWWWWW
WFWFWFFFW
WWWWWWWWW
