DEFAULT
5,1

WWWWWWWWWWWWWWWWWWW
WFFFFFFFFFFFFFFFWFW
WFFWFWFWFFFWFFFWWWW
WWFWFWFWFFWWWWWFFFW
WFFWFWFWFFWFWFWFFWW
WWWWWWWWFFWWWWWFFFW
WFFWWWWWFFWFFFWFWWW
WWWWWWWWWFWWWWWFFFW
WFFFWFWFWFWWWWWFFFW
WFFFWFWFWFWFFFWFFFW
WFFFWFWFWFWWWWWFWWW
WEFFFFFFFFFFFFFFFFW
WWWWWWWWWWWWWWWWWWW
