DEFAULT
5,1

WWWWWWWWWWWWWWWWWWW
WFFFFFFWFFFFFFFFWFW
WFFFFWWWFFFWFFFWWWW
WWFFFDFFFFWWWWWFFFW
WWWWWWFWWFWDWPWFFWW
WFFWFWFWWFWWWWWFFFW
WFFWFWFFFFWPWFWFWWW
WWWWDWFFFFWWWWWFFFW
WFFFFFFFFFFFWFFFFFW
WWWFFFFFFWWWWFWWWFW
WFFFFWWFFWWFWWWFWWW
WEFFFFWFFFFFFFWFFFW
WWWWWWWWWWWWWWWWWWW
