DEFAULT
5,1

WWWWWWWWWWWWWWWWWWW
WFFFFFFWFFFFFFFFWFW
WFFFFWWWFFFWFFFWWWW
WWFFFDFFFFWWWWWFFFW
WFFFFWWWFFWFWFWFFWW
WFFFFWWWFFWWWWWFFFW
WFFFFWWWFFWFFFWFWWW
WFFFFWFWFFWWWWWFFFW
WFFFFWFWFFWWWWWFFFW
WWWFFWFWFFWFFFWFFFW
WFFFFFFFFFWWWWWFWWW
WEFFFFFFFFFFFFFFFFW
WWWWWWWWWWWWWWWWWWW
