DEFAULT
7,1

WWWWWWWWW
WFWFWFFFW
WFFFWFFWW
WWWFFFFFW
WEWFWWWWW
WFWFWFFFW
WWWWWWWWW
