DEFAULT
7,1
1,1;
WWWWWWWWW
WFWFWFFFW
WFFFWWWFW
WWWFFFFFW
WEWFWWWFW
WFFFWFFFW
WWWWWWWWW
