TEMPLE
10,54

PPPPPPPPPPPPPPPPPPPPPPPPPPPPPPPPPPPPPPPPPPPPPPPPPPPPPPPPPPPPPPPP
PPPPPPPPPPPPPPPPPPPPPPPPPPPPPPPPPPPPPPPPPPPPPPPPPPPPPPPPPPPPPPPP
PPPPPPPPPPPPPPPPPPPPPPPPPPPPPPPPPPPPPPPPPPPPPPPPPPPPPPPPPPPPPPPP
PPPPPPPPPPPPPPPPPPPPPPPPPPPPPPPPPPPPPPPPPPPPPPPPPPPPPPPPPPPPPPPP
PPPPPPPPPPPPPPPPPPPPPPPPPPWWWWWPPPPPPPPPPPPPPPPPPPPPPPPPPPPPPPPP
PPPPPPPPPPPPPPPPPPPPPPPPPPWFEFWPPPPPPPPPPPPPPPPPPPPPPPPPPPPPPPPP
PPPPPPPPPPPPPPPPPPPPPPPPPPWFFFWPPPPPPPPPPPPPPPPPPPPPPPPPPPPPPPPP
PPPPPPPPPPPPPPPPPPPPPPPPPPWFFFWPPPPPPPPPPPPPPPPPPPPPPPPPPPPPPPPP
PPPPPPPPPPPPPPPPPPPPPPPPPPWFFFWPPPPPPPPPPPPPPPPPPPPPPPPPPPPPPPPP
PPPPPPPPPPPPPPPPPPPPPPPPPPWFFFWPPPPPPPPPPPPPPPPPPPPPPWWWPPPPPPPP
PPPPPPPPPPPPPPPPPPPPPPPPPPWFFFWPPPPPPPPPPPPPPPPWWWWWWWWWWPPPPPPP
PPPPPPPPPPPPPPPPPPPPPPWWWWWWDWWWWWWWWPPPPPPPPPWWFFFFFFFFWWPPPPPP
PPPPPPPPPPPPPPPPPPPPPPWFFFFFFFFFFFFWWPPPPPPPPWWFFFFFFFFFWWPPPPPP
PPPPPPPPPPPPPPPPPPPPPPWFFFFFFFFFFFFWWPPPPPPPWFFFFFFFFFFFWWPPPPPP
PPPPPPPPPPPPPPPPPPPPPPWWFFFFFFFFFFFWWWPPPPPWWFFFFFFFFFFFWPPPPPPP
PPPPPPPPPPPPPPPPPPPPPWWWWWWWWWWFFWWWWWWPPPWWFFFFFFFFFFFFWPPPPPPP
PPPPPPPPPPPPPPPPPPPPPWWPPPWWWWWFFWWWWWWPPWWFFFFFFFFFFFFWWPPPPPPP
PPPPPPPPPPPPPPWWWWWWWWPPPPPWWWWFFWWWWWWWWWWWFFFFFFFFFFWWPPPPPPPP
PPPPPPPPPPPPPPWFFFWFFWWPPPPWFFFFFFFFFWWWWWWWFFFFFFFFFFWPPPPPPPPP
PPPPPPPPPPPPPWWWFFFFFWWWWWPWWFFFFFFFFWWWWWFFFFFFFFFFFWWPPPPPPPPP
PPPPPPPPPPPPPWFWWFFFFFWWFWWWWWFFFFFFFWWWWFFFFFFFFWWWWWPPPPPPPPPP
PPPPPPPPPPPPPWFWWWFFFFWWFFWWWWFFFFFFFWWWWFFFFFFWWWPPPPPPPPPPPPPP
PPPPPPPPPPPPPWFFFFFFFFFFFFFFWWFFFFFFFWWWFFFFFFWWWPPPPPPPPPPPPPPP
PPPPPPPPPPPPPWWFFFFFFFFFFFFFFFFFFFFFFFFFFFFFFWWPPPPPPPPPPPPPPPPP
PPPPPPPPPPPPPPWWFFFFFWFFFFFFFFFFFFFFFFFFFFFFWWPPPPPPWWWWWWPPPPPP
PPPPPPPPPPPPPPPWWFFWWWFFFWFFFFFFFFFFFFFFFFFWWPPPPPWWWFFFFWWPPPPP
PPPPPPPPPPPPPPPPWWWWWWFFWWWFFFWWFFFFFFFFFFFWPPPPPWWWFFFFWWWWPPPP
PPPPPPPPPPPPPPPPPPPWWWWWWWWWWWWWWFFFFFFFFFFWPPPPPWWWWFFFWWWWWPPP
PPPPPPPPPPPPPPPPPPPPPPWWPPPPPWWWWFFFFFFFFFFWWPPPWWWWWFFFFFFFWPPP
PPPPPPPPPPPPPPPPPPPPPPPPPPPPPPPWWFFFFFFFFFFFWPPPWFFFWFFFFFFFWPPP
PPPPPPPPPPPPPPPPPPPPPPPPPPPPPPPPWFFFFFFFFFFWPPPPWFFFFFFFFFFFWWPP
PPPPPPPPPWWWWWWWWWWWPPPPPPPPPPPPWFFFFFFFFFWWPPPPWFFFFFFFFFFFWWPP
PPPPPPPPWWFFFFFFFFFWWPPPPPPPPPPPWFFFFFFFFWWPPPPPWFFFFFFFFFWWWWPP
PPPPPPPWWFFFFFFFFFFFWPPPPPPPPPPPWFFFFFFFFWWPPPPPWFFWWFFFFWWWWWPP
PPPPPPPWFFFFFFFFFFFFWWPPPPPPPPPPWFFFFFFFFWWPPPPWWFFWWWFFFFFWWWPP
PPPPPPPWFFFFFFFFFWFFFWPPPPPPPPPPWFFFFFFFFFWWPPWWWFFFWWFFFFFFWWPP
PPPPPPPWFFFFWFFFFFFFFWPPPPPPPPPPWFFFFFFFFFFWWWWWFFFFWWWFFFFFWWPP
PPPPPPPWFFFFFFFFFFFFFWPPPPPPPPPPWFFFFFFFFFFFWWWFFFFFWPPWFFFFWPPP
PPPPPPPWFFFFFFFFFFFFFWPPPPPPPPPPWFFFFFFFFFFFFFFFFFFWWPPWWFFWWPPP
PPPPPPPWFFFFFFFFFFFFFWWWWWWWWWWWWFFFFFFFFFFFFFFFFFFWWPPPWWWWPPPP
PPPPPPPWFFFFWFFFFFWFFFFFFFFFFFFFFFFFFFFFFFFFFFFFFWWWPPPPPPPPPPPP
PPPPPPPWWFFFFFFFFFFFFFFFFFFFFFFFFFFFFFFFFFFFFFFFWWWPPPPPPPPPPPPP
PPPPPPPPWFFFFFFWFFFFFFWWWWWWWWWWWFFFFFFFFFFFFFWWWPPPPPPPPPPPPPPP
PPPPPPPPWWFFFFFFFFFFFFWPPPPPPPPPWFFFFFFFFFFFFWWPPPPPPPPPPPPPPPPP
PPPPPPPPPWWFFFFFFFFFFFWPPPPPPPPPWFFFFFFFFFFWWWPPPPPPPPPPPPPPPPPP
PPPPPPPPPPWWFFFFFFFFFFWPPPPPPPPPWFFFFFFFFWWWPPPPPPPPPPPPPPPPPPPP
PPPPPPPPPPPWWFFFFFFFFFWPPPPPPPPPWFFFFFFFWWPPPPPPPPPPPPPPPPPPPPPP
PPPPPPPPPPPPWWFFFFFFFFWPPPPPPPPPWFFFFFFWWPPPPPPPPPWWWWWWWWWWPPPP
PPPPPPPPPPPPPWFFFFFFFFWPPPPPPPPPWFFFFFFWWWWWWWWWWWWWFWWWWFFWWPPP
SSSSSSSSSSSSWWFFFFFFFFWPPPPPPPPPWFFFFFWWFFFFFFWWWWWFFFWWFFFFWWPP
PPPPWWWWWWWWWFFFFFFFFFWPPPPPPPPWWFFFFFWFFFFFFFFFWWFFFFWWFFFFFWPP
WWWWWFFFFFFFFFFFFFFFFFWWPPPPPPWWFFFFFFFFFFFFFFFFFWFFFFWFFFFFWWPP
WFFFFFFFFFFFFFFFFFFFFFFWWWPPPPWFFFFFFFFFFFFFFWFFFFFFFFFFWWWWWPPP
WFFFFFFFFFFFFFFFFFFFFFFFFWWWWWWFFFFFFFFFFFFFWWFFFFFFWFFFWWWPPPPP
WFFFFFFFFFFFFFFFFFFFFFFFFFFFFFFFFFFFFFFFFFFWWWWFFFWWWFFWWWPPPPPP
WFFFFFFFFFFFFFFFFFFFFFFFFFFFFFFFFFFFFFWWWWWWWWWWWWWWWWWWPPPPPPPP
WWFFFFFFFFFFFFFFFFFFFFFFFFFFFFFFFFFFFWWPPPPPPPPPPPPPPPPPPPPPPPPP
PWWWWWWWWWWWWWFFFFFFFFFFFFFFFFFFFFFWWWPPPPPPPPPPPPPPPPPPPPPPPPPP
SSSSSSSSSSSSSWWFFFFFFFFFFFFFFFFFWWWWPPPPPPPPPPPPPPPPPPPPPPPPPPPP
SSSSSSSSSSSSSPWWFFFFFFFFFFFFFFFWWPPPPPPPPPPPPPPPPPPPPPPPPPPPPPPP
SSSSSSSSSSSSSPPWWFFFFFFFFFFFFFWWPPPPPPPPPPPPPPPPPPPPPPPPPPPPPPPP
SSSSSSSSSSSSSPPPWWWWWWWWWWWWWWWPPPPPPPPPPPPPPPPPPPPPPPPPPPPPPPPP
