TEMPLE
2, 2
14,7;21,12;30,14;14,17;2,12;
SWWWSSSSSSSSSSSSSSSSSSSSSSSSSSSSS
SWEWSSSSSSSSSSSSSSSSSSSSSSSSSSSSS
SFFFPPPPPSSSSSSSSSSSSPPPPPSSSSSSS
SFFFPPPPPPSSSSSSSSSSPPPPPPPSSSSSS
SFFFPPPPPPPSSSSSSSSPPPPPPPPPSSSSS
SPPSSSSSSPPPSSSSSSPPPSSSSSPPPSSSS
SPPSSSSSSSPPPFFFPPPPSSSSSSSPPPSSS
SPPSSSSSSSSPPFFFPPPSSSSSSSSPPPPSS
SPPSSSSSSSSSPFFFPPSSSSSSSSSSPPPSS
SPPSSSSSSSSSSSSSSSSSSSSSSSSSPPPSS
SPPSSSSSSSPPSSSSSSSSSSSSSSSSPPPPS
SFFFSSSSPPPPPPPPPPPPFFFPSSSSSPPPS
SFFFSSSPPPPPPPPPPPPPFFFPPSSSSPPPS
SFFFPSPPPPSSSSSSSSSSFFFPPPSSSFFFS
SSPPPPPPPPPPSSSSSSSSSPPSSSSSSFFFS
SSSPPPPPPPPPPSSSSSSSPPPSSSSSSFFFS
SSSSPPPPPPPPPFFFSSSSPPPSSSSSSPPPS
SSSSSSSSSPPPPFFFPPPPPPPSSSSSSPPPS
SSSSSSSSSSSSPFFFPPPPPPSSSSSSSPPPS
SSSSSSSSSSSSSSSPPPPPPSSSSSSSPPPPS
SSSSSSSSSSSSSSSSSPPPPPPSSSPPPPPSS
SSSSSSSSSSSSSSSSSSSPPPPPPPPPPPSSS
SSSSSSSSSSSSSSSSSSSSPPPPPPPPPSSSS
SSSSSSSSSSSSSSSSSSSSSSPPPPPSSSSSS
SSSSSSSSSSSSSSSSSSSSSSSSSSSSSSSSS
