DEFAULT
3.513375,1.2797127

WWWWWWWWWWWWWWWWWWWWWPPPPPPPPPPPPPP
WPFFFPWPPPPPPPPPPPPPWWPSPSPSPSSPPPP
WPFFFPWSSPFFFFFFFFFPPWWPSSSSSSSPPPP
WPFFFPWSPFFFFFFFFFFFPPWWWWWWWPPPPPP
WPFFFPWSFFFFFFFFFFFFFPPPPPPPWWPPPPP
WPFFFPWSFFSSSSSSSSFFFFFFFFFPPWWPPPP
WPFFFPWSFFSSSSSSSSSFFFFFFFFFPPWWPPP
WPFFFPWSFFSSSSSSSSSSFFFFFFFFFPPWWPP
WPFFFPWSFFFSSSSSSSSSSSSSSSFFFFPPWWP
WPFFFPWSPFFFFFFFFFSSSSSSSSSFFFFPPWP
WPFFFPWSSPFFFFFFFFFSSSSSSSSSFFFFPWP
WWWDWWWPSSSSSSSSSFFFSSSSSSSSSFFFPWP
WSFFFPWPPPPPPPPPSSFFFSSSSSSSSFFFPWP
WSFFFPWSSSSPPPPPPSSFFFSSSSSSSFFFPWP
WSFFFPWWSSSSSSSSPPSSFFFSSSSSSFFFPWP
WSFFFPPWWSSSSSSSSPPSFFFSSSSSPFFFPWP
WSFFFFPPWWSSSSSSPPSSFFFSSSSSPFFFPWP
WPPFFFFPPWWSSSSPPSSFFFFSSSSSFFFPPWP
WWSPFFFFPPWWWWWWSSFFFFSSSSSFFFPPWWP
PWWPPFFFFPPPPPPWSFFFFSSSSSFFFPPWWPP
PPWWPPFFFFFFFFFWFFFFSSSSSFFFPPWWPPP
SPPWWPPFFFFFFFFDFFFSSSPFFFFPPWWPPPP
SSPPWWPPFFFFFFFWFSSSSSFFFFPPWWSPPPP
SSSPPWWPPPPPPPPWPPPPPPFFFPPWWSSPPPP
SSSSPSWWWWWWWWWWWWWWWWWEWWWWPPSPPPP
