TEMPLE
1.3852395,2.455339
13,7;20,12;29,14;13,17;1,12;
WWWSSSSSSSSSSSSSSSSSSSSSSSSSSSSS
WEWSSSSSSSSSSSSSSSSSSSSSSSSSSSSS
FFFPPPPPSSSSSSSSSSSSPPPPPSSSSSSS
FFFPPPPPPSSSSSSSSSSPPPPPPPSSSSSS
FFFPPPPPPPSSSSSSSSPPPPPPPPPSSSSS
PPSSSSSSPPPSSSSSSPPPSSSSSPPPSSSS
PPSSSSSSSPPPFFFPPPPSSSSSSSPPPSSS
PPSSSSSSSSPPFFFPPPSSSSSSSSPPPPSS
PPSSSSSSSSSPFFFPPSSSSSSSSSSPPPSS
PPSSSSSSSSSSSSSSSSSSSSSSSSSPPPSS
PPSSSSSSSPPSSSSSSSSSSSSSSSSPPPPS
FFFSSSSPPPPPPPPPPPPFFFPSSSSSPPPS
FFFSSSPPPPPPPPPPPPPFFFPPSSSSPPPS
FFFPSPPPPSSSSSSSSSSFFFPPPSSSFFFS
SPPPPPPPPPPSSSSSSSSSPPSSSSSSFFFS
SSPPPPPPPPPPSSSSSSSPPPSSSSSSFFFS
SSSPPPPPPPPPFFFSSSSPPPSSSSSSPPPS
SSSSSSSSPPPPFFFPPPPPPPSSSSSSPPPS
SSSSSSSSSSSPFFFPPPPPPSSSSSSSPPPS
SSSSSSSSSSSSSSPPPPPPSSSSSSSPPPPS
SSSSSSSSSSSSSSSSPPPPPPSSSPPPPPSS
SSSSSSSSSSSSSSSSSSPPPPPPPPPPPSSS
SSSSSSSSSSSSSSSSSSSPPPPPPPPPSSSS
SSSSSSSSSSSSSSSSSSSSSPPPPPSSSSSS
