DEFAULT
3.513375,1.2797127

WWWWWWWWWWWWWWWWWWWWWPPPPPPPPPPPPPP
WPFFFPWPPPPPPPPPPPPPWWPPPPPPPPPPPPP
WPFFFPWPPPFFFFFFFFFPPWWPPPPPPPPPPPP
WPFFFPWPPFFFFFFFFFFFPPWWWWWWWPPPPPP
WPFFFPWPFFFFFFFFFFFFFPPPPPPPWWPPPPP
WPFFFPWPFFPPPPPPPPFFFFFFFFFPPWWPPPP
WPFFFPWPFFPPPPPPPPPFFFFFFFFFPPWWPPP
WPFFFPWPFFPPPPPPPPPPFFFFFFFFFPPWWPP
WPFFFPWPFFFPPPPPPPPPPPPPPPFFFFPPWWP
WPFFFPWPPFFFFFFFFFPPPPPPPPPFFFFPPWP
WPFFFPWPPPFFFFFFFFFPPPPPPPPPFFFFPWP
WWWDWWWPPPPPPPPPPFFFPPPPPPPPPFFFPWP
WPFFFPWPPPPPPPPPPPFFFPPPPPPPPFFFPWP
WPFFFPWPPPPPPPPPPPPFFFPPPPPPPFFFPWP
WPFFFPWWPPPPPPPPPPPPFFFPPPPPPFFFPWP
WPFFFPPWWPPPPPPPPPPPFFFPPPPPPFFFPWP
WPFFFFPPWWPPPPPPPPPPFFFPPPPPPFFFPWP
WPPFFFFPPWWPPPPPPPPFFFFPPPPPFFFPPWP
WWPPFFFFPPWWWWWWPPFFFFPPPPPFFFPPWWP
PWWPPFFFFPPPPPPWPFFFFPPPPPFFFPPWWPP
PPWWPPFFFFFFFFFWFFFFPPPPPFFFPPWWPPP
PPPWWPPFFFFFFFFDFFFPPPPFFFFPPWWPPPP
PPPPWWPPFFFFFFFWFPPPPPFFFFPPWWPPPPP
PPPPPWWPPPPPPPPWPPPPPPFFFPPWWPPPPPP
PPPPPPWWWWWWWWWWWWWWWWWEWWWWPPPPPPP
