DEFAULT
3.5636187,12.461691
14,23;18,23;22,23;22,15;18,15;14,15;
WWWWWWWWWWWWWWWWWWWWWWWWWWWWWWWWWWWWWWWWWWWWW
WFFFFFFFFFFWFFFFFDFFFFFFFFWFFHFFFFFFFFFFFFFFW
WFFFFFFFFFFWFWWWFWFWWFFWWFWHFHFFFFFFFFFFFFFFW
WDWWWWFFFFFDFWHWFWFWWFFWWFWHFFFFEFFFFFFFFFFFW
WFFFWWFFFFFWFWWWFWFFFFFFFFWFFHFFFFFFFFFFFFFFW
WWFFFWFFFFFWFFFFFWFFFFFFFFWHFHFFFFFFFFFFFFFFW
PWFFFWFFFFFWWWWWHWFWWFFWWFWHFFFFFFFFFFFFFFFFW
PWFFFWFFFFFDFFFWFWFWWFFWWFWFFHFFFFFFFFFFFFFFW
PWFFFWFFFFFWWWFWFWFFFFFFFFWHFHFFFFFFFFFFFFFFW
WWWDWWWWWDWWFFFWFDFFFFFFFFWHFFFFFFFFFFFFFFFFW
WHFFFHWFFFWHFWWWFWFWWFFWWFWFFHFFFFFFFFFFFFFFW
WFFFFFWFFFWHFFFWFWFWWFFWWFWHFHWWWWWWWWWWWWWWW
WFFFFFWFFFWWWWFWFWFFFFFFFFWHFFFFWPPPPPPPPPPPW
WHFFFHWFFFDFFWFFFWWWWWWWWDWWWWWEWFFFFFFFFFFFW
WHFFFHWFWWWWFWWWWWWWWWWWPFPPPPPFWPPPPFFPFFPPW
WWWWWWWDWFFWFWFHFHFHFHFWPFPFFFPFWFFFFFPPPFFPW
WHWFFFWFWFWWFWHHFHHHFHHWPFPFPPPFWFPFPFPFFPFFW
WWFFWFFFWFFFFWFFFFFFFFFWPFPFFPPFDFPPPPPFPPPFW
WFFWWWWWWWWWWWFFFHHHFFFWPFPPFPPPWPPFFFFFFWFFW
WFWWFFFFFFFFFDFFFHFHFFFDFFFFFPPPWPPPPFPPPPPFW
WFFWFFFFFFFFFWFFFHHHFFFWPPFPFPPPWPFFFFPFFFPFW
WWFWFFFFFFFFFWFFFFFFFFFWPPFPFPPFDFFPPFPFPFFFW
WFFWFFFFFFFFFWHHFHHHFHHWFFFPFPPFWPFPPFPFPPPPW
WFFDFFFFFFFFFWFHFHFHFHFWPPPPFFFFWPFFFFFFFFFFW
WWWWWWWWWWWWWWWWWWWWWWWWWWWWWWWWWWWWWWWWWWWWW
