DEFAULT
1, 7
9,4;10,4;11,4;12,4;13,4;14,4;15,4;
WWWWWWWWWWWWWWWWW
WHFFFFFFWPPPPPPPW
WHFFFFFFWPPPPPPPW
WFFFFFFFWWWWWWWWW
WFFFFFFFDFFFFFFFE
WFFFFFFFWWWWWWWWW
WFFFFFFHWPPPPPPPW
WFFFFFFHWPPPPPPPW
WWWWWWWWWWWWWWWWW
