DEFAULT
2.6287937,11.316677
2,12;3,11;2,14;5,13;
SWWWWWWWWWWWWWW
SWEFFFFFFFFFFFW
SWWWWWWWWWWWWFW
SSSSSSSSSSSSWFW
SSSSSSSSSSSSWFW
SSSSSSSSSSSSWFW
SSSSSSSSSSSSWFW
SSSSSSSSSSSSWFW
SSSWWWSSSSSSWFW
WWWWFWSSSSSSWFW
WFFFFWSSSSSSWFW
WWFWFWWWWWWWWFW
WWFFFDFFFFFFFFW
WWFWWWFFFFFFFFW
WWWWWWWWWWWWWWW
