DEFAULT
9.45919,5.376802
7,7;13,6;1,8;8,3;
SSSSSWWWWWSSSSS
SSSSSWFFFWSSSSS
SSSSSWFFFWSSSSS
SSSSSWFFFWSSSSS
SSSSWWWDWWWSSSS
WWWWWFFFFFWWWWW
WFFFWFFFFFWFFFW
WFFFDFFFFFDFFFW
WFFFWFFFFFWFFFW
WWWWWFFFFFWWWWW
SSSSWWWDWWWSSSS
SSSSSSWFWSSSSSS
SSSSSSWFWSSSSSS
SSSSSSWEWSSSSSS
