DEFAULT
1.7457666,5.4891
6,5;4,8;7,9;5,2;8,1;
WWWWWWWWWWWW
WFFFFFFFFFFW
WFFFFFFFFFFW
WFFWWWWWWFFW
WFFWWWWWWFHW
WFFFFFFFFFEW
WFFWWWWWWFHW
WFFWWWWWWFFW
WFFFFFFFFFFW
WFFFFFFFFFFW
WWWWWWWWWWWW
