DEFAULT
1.549226,5.326328
4,7;4,8;
WPPPPPPPPFFFFFFFFF
WPPWWWWPPFHPPPPPHF
WPPWWWWPPFPPPPPPPF
WPPPPPPSPFPPPPPPPF
WPPPSPPPHFPPWSHPPF
DFFFFFFFFFPPWSPPPF
WPPHFWPPPHPPWSPPPF
WPPPFPPPPPPPWSHPPF
WPPPFPPWWWWSPPPPPF
WPPPFHPPPPPPPPPPHF
EFFFFFFFFFFFFFFFFF
WPPPPPPPHHPPWWWWWW
