FIRE
1.5,4.5
3,6;5,6;7,6;9,6;9,2;7,2;5,2;3,2;
WWWWWWWWWWWWW
WHFFFFFFFFFHW
WFFWFWFWFWFFW
WFFFFFFFFFFFW
WFFFFFFFFFFFE
WFFFFFFFFFFFW
WFFWFWFWFWFFW
WHFFFFFFFFFHW
WWWWWWWWWWWWW
