Version: 2
DEFAULT
1.0,6.0
Point1:4.0,9.0;Point0:4.0,8.0

PPPPPPPPPPPPPPPPPPP
PPPPPPPPPPPPPPPPPPP
EFFFFFFFFFFFFFFFFFP
WPPPFPPPPPPPPPPPPFP
WPPPFPWWWWWWWWWWPFP
WPPPFPWWWWWWSSSWPFP
WPPSFPPPPPPWSSSWPFP
WFFFFFFFFFPWSSSWPFP
WPPPPPPPPFPWSSSWPFP
WWWWWWWWPFPWSSSWPFP
SWFFFFFWPFPWWWWWPFP
SWFFFFFWPFPPPPPPPFP
SWWWWWWWPFFFFFFFFFP
SSWSSSSSPPPPPPPPPPP