DEFAULT
1.5350659,8.297967
4,10;4,9;4,8;11,9;11,8;10,8;13,8;13,5;13,4;4,5;
WWWWWPPPPPPPPPPPPP
WPPPPPPPPPPPPPPPPP
WPPPPPPPPPPPPPPPPP
WPPFFFFFFFFFFFFFPP
WPPFPPPPPPPPPFPFPP
EFFFFPPFFFFFPFPFPP
WPPPPPPFPPPFPPPFPP
WPPPPPPFPPPFPPPFPP
WFFFFFFFPPFFPFPFPP
WPPPFPPPPPPFFFFFPP
WPPPFPPPPPPPPPPPPP
WWWWWPPPPPPPPPPPPP
