DEFAULT
1,8
10,6;8,6;15,10;
SSSSSSSSSWEWSSSSS
SSSSSSSSSWFWSSSSS
SSSSWWWWWWDWWWSSS
SSSSWFFFFFFFFWSSS
SSSSWFWWWWWWFWSSS
SSSSWFWWFWWWDWSSS
SSSSWFWWFFFFFWSSS
WWWWWFWWFWWWWWSSS
WFFFFFFDFWSSSWWWW
WWWWWWWWFWWWWWFFW
SSSSSSSWFFFFDFFFW
SSSSSSSWWWWWWFFFW
SSSSSSSSSSSSWWWWW

