FOREST
7.5,7.5

WWWWWWWWWWWWWWW
WEWWWFFFWWWFFFW
WFWFFFWFFWFFWFW
WFWFWWWWFWFWWFW
WFFFWFFFFWFWFFW
WWWWWFWWWWFWFWW
WFFFWFWFFFFWFFW
WFWFFFWFWWWWWFW
WFWWWWWWWWFFFFW
WFFFWFFFFWFWWWW
WWWFWFWWFWFWWWW
WFFFWFFWFWFFFWW
WFWWWWFWFWWWFWW
WFFFFFFWFFFFFWW
WWWWWWWWWWWWWWW
