DEFAULT
1.245047,7.50886

WWWWWWWWWWWWWWWWWWWWWWWWWWWW
WFFFFFWFFFFHFFFPHPFPPFFFFFFW
WFFFFFWFFPFHFFPPFPFPPFPFFHFW
WFFFFFWFFPFFFPFPHPFPPFPFHHFW
WFFWFFWFFFFFFFFPHPFFFFPFFFFW
WFFWFFWFFFFHFFFPFPFFFFFFFFHW
WFFWFFFFPFHHHFFPFPFPPPFPFFFW
DFFWFFFFFFFHFFFPFPFPPPFPFFFE
WFFWFFFFFPFFFFFPHPFPPPFPFFFW
WFFWFFWFFFFFFPFPHPFFFFFFFFFW
WFFWFFWFFHFPFFFPFPFFFFPFFFFW
WFFFFFWFFHFFFFFPFPFPPFPFFHFW
WFFFFFWFFFPFHFFPHPFPPFPFFHHW
WFFFFFWFFFPFHFFPFPFPPFFFHFFW
WWWWWWWWWWWWWWWWWWWWWWWWWWWW
