DEFAULT
1,6
10,4;8,4;15,8;
SSSSWWWWWWEWWWSSS
SSSSWFFFFFFFFWSSS
SSSSWFWWWWWWFWSSS
SSSSWFWWFWWWDWSSS
SSSSWFWWFFFFFWSSS
WWWWWFWWFWWWWWSSS
WFFFFFFDFWSSSWWWW
WWWWWWWWFWWWWWFFW
SSSSSSSWFFFFDFFFW
SSSSSSSWWWWWWFFFW
SSSSSSSSSSSSWWWWW

