FOREST
1.5,6.5
1,10;3,7;5,10;7,9;
SSSSSSSSSSSWWWSSWWWSSWWWSSWWWS
SSSSSSSSSSSWEWSSWEWSSWEWSSWEWS
SSSSSSSSSSSWFWSSWFWSSWFWSSWFWS
SSSSSSSSSSSWFWSSWFWSSWFWSSWFWS
SSSSSSSSSSSWDWSSWDWSSWDWSSWDWS
WWWWWWWSSSSWFWSSWFWSSWFWSSWFWS
WFWFFFWWWWWWFWWWWFWWWWFWWWWFWW
WFWFWFWFFFFFFFFFFFFFFFFFFFFFFW
WFWFWFWFWWWWWWWWWWWWWWWWWWWWWW
WFWFWFWFWSSSSSSSSSSSSSSSSSSSSS
WFWFWFWFWSSSSSSSSSSSSSSSSSSSSS
WFFFWFFFWSSSSSSSSSSSSSSSSSSSSS
WWWWWWWWWSSSSSSSSSSSSSSSSSSSSS
