FOREST
7.5,7.5

WWWWWWWWWWWWWWW
WEWWWFWFWWWFFFW
WFWFFFFFFWFFWFW
WFWFWWWFWWFWWWW
WFFFWFFFWFFWFFW
WWWWWFWWWFWWFWW
WFFFFFWFFFFWFFW
WFWWWFWFWWFWWFW
WFWFWFWWWFFWWFW
WFWFFFFFWWFFFFW
WFWWWFWWWWFWFWW
WFWFWFFWFFFWFWW
WFWWWWFWWWWWFWW
WFFWFFFFFFFFFWW
WWWWWWWWWWWWWWW
