DEFAULT
6.5,4.5

WWWWWWWWWWWW
WFFWFFFFFFHW
WFFDFFFFFFHW
WFFWFFFFFFFW
WFFWFFFWWWWW
WFFWWWWWFEHW
WFFFFFFWFFFW
WFFFFFFWFFFW
WHFFFFFFFFFW
WWWWWWWWWWWW
