Version: 2
DEFAULT
1.0,5.0
Point1:4.0,8.0;Point3:5.0,2.0;Point2:7.0,9.0;Point4:8.0,1.0;guard:7.0,5.0

WWWWWWWWWWWW
WFFFFFFFFFFW
WFFFFFFFFFFW
WFFWWWWWWFFW
WFFWWWWWWFWW
WFFFFFFFFFEW
WFFWWWWWWFWW
WFFWWWWWWFFW
WFFFFFFFFFFW
WFFFFFFFFFFW
WWWWWWWWWWWW