DEFAULT
1, 1

WWWHWWWHWWWHWWW
WFWFFFFFFFFFFFW
WFWFWWWWWWWWWFW
HFWFWFFFFFFFWFH
WFWFWFWWWWWFWFW
WFWFWFWFFFWFWFW
WFWFWFWFWFWFWFW
HFWFWFWEWFWFWFH
WFWFWFWWWFWFWFW
WFWFWFFFFFWFWFW
WFWFWWWWWWWFWFW
HFWFFFFFFFFFWFH
WFWWWWWWWWWWWFW
WFFFFFFFFFFFFFW
WWWHWWWHWWWHWWW
