DEFAULT
2,10
2,11;3,10;2,13;1,10;
SSSSSSSSSSSSSSS
SSSSSSSSSSSSSSS
SSSSSSSSSSSSSSS
SWWWWWWWWWWWSSS
SWEFFFFFFFFWSSS
SWWWWWWWWWFWSSS
SSSSSSSSSWFWSSS
SSSSSSSSSWFWSSS
SSSWWWSSSWFWSSS
WWWWFWSSSWFWSSS
WFFFFWSSSWFWSSS
WWFWFWWWWWFWSSS
WWFFFDFFFFFWSSS
WWFWWWFFFFFWSSS
WWWWWWWWWWWWSSS
