DEFAULT
6.5,4.5

SSSWWWWWWWWW
WWWWFFFFFFFW
WFFFFFFFFFFW
WFFWWFFFFFFW
WFFWWFFWWWWW
WFFWWWWWFEFW
WFFFFFWWFFFW
WFFFFFWWFFFW
WWFFFFFFFFFW
SWWWWWWWWWWW


