DEFAULT
10,7
5,5;4,3;5,1;8,1;12,3;19,3;
SSSWWWWWWWWWWWSSWWEWW
SSSWFFFFFFFFFWSSWFFFW
SSSWFFFFFFFFFWWWWFFFW
SSSWFFFFFFFFFWFFFFFFW
SSSWWWWWWFFFFFFFFFFFW
SSSWFFFFDFFFFFFWWFFFW
SSSWFFFFWFFFFFFWWWWWW
SSSWFFFFWFFFFWWWSSSSS
SSSWWWWWWWDWWWSSSSSSS

