DEFAULT
10.516069,11.326213
6,10;6,11;7,11;3,9;13,11;13,10;13,9;16,8;17,10;15,6;18,4;11,1;
SSSSSSSSWWWEWWWSSSSSS
SSSSSSSSWFFFFFWSSSSSS
SSSSSSSSWFFFFFWWWWWWS
SSSSSSSSWFFFFFWFFFFWS
SSSSSSSSWFFFFFFFFFFWS
WWWWWWWWWFFFFFWFFFFWS
WFFFFFFWWFFFFFWFFFFWS
WFWWWWFWWFFFFFWWWWWWS
WFWWWFFFWFFFFFDFFFFWS
WFWFDFFFWFFFFFWFFFFWS
WFWWWWFWWFFFFFWFFFFWS
WFFFFFFFFFFFFFWFFFFWS
WWWWWWWWWWWWWWWWWWWWS
